-XX--XX-XXX------------XXXXXXX---------------XXXXXXX--------------XXXX-----------------------XXXXXXX---------------XXX--
X..XX.:X...X----------X.:.....X-------------X..H.H..X------------X.E..X---------------------X.......X-------------X...X-
-X..X.......X---------X......E.X------------X.......X------------X..XX----------------------X.......X-X-----------X.H.X-
X...X....H..X---------X........X------------X....E..X------------X..X-----------------------X........X.X----------X...X-
-X.E........XXX--------X.....XX-------------X.E......X-----------X..X---X-------------XXXXXX.H.........X----------X...X-
-X...X.........X-------X.....X--------------X.......X-----------XX..XX-X.XXXXXX-----XX............E....X-----------X..X-
-X..XX....XX...X-------XH.EXX-------------XXX.....XX-----------X.X....X........X---X.........:.........X--X--------X..X-
X..X--X..X--XX..XXXXXXX....XXXX----------X....X...X--XX--------X........E.......XXX..........XX.X.......XXHX-------X..X-
X..X--X..X---X....E.....E......X---------X.......E.XX..X-------X.....X.....XXX...H..........XX..H...E...X..X-------X...X
X...XX...X----XX........XX.E...X---------X.............X------X......X.:...X--X..........X.E.X.........H...X--XXXXX....X
X..E....EX------X......X--X.....X-------X......E...A..X-------X......X.....X---XXXXXXXXXX-X..A.........XXXXX-X....X....X
X.....H..X------X.....X---X.....X-----XX...........X.X--------X....XXXE.XXX----------------X....X....XX-XXX.X....:X...X-
X.....XX.X------X....X.XXX.......X---X.........H..X-X---------X....X--XX-------------------X.XXH.......X..B.........:.X-
X......X..X------X.XX...........H.X--X............X-----------X....X----------------------X..X.......A.E...............X
X...E......X------X--X..H...E...X.X--X..H....E....X-----------X...X-----------------------X.......E......H..........E..X
X......H...X----------XXX.....E...X--X.............X-----------XX.X-----------------------X........XX.............:XXXX-
X......XX..X-------------X.......X--X......EXXX.....XXX----------X-------------------------X...X..X--X.XXXX........X----
X.......E..X-----XXX-----X..E..XX---X.H.XX..X-X........X-----------------------------------X...H..X---X---X........X----
X..........X----X..<X-----XX....X----X.X--X.X-X......X.X-----------------------------------X......X-------X.E.......X---
X..........XXXXXX..X--------XXX.X----X.X-X..X-X.....XX.X-----------------------------XXXXXXX.E...X-XXXXXXXX.....A..X----
X..E...H...X...H...X---------X...XXX-X.X--XX---X...X-X.X----------------------------X...........HXX...............XXXXX-
X......XX........B.X---------XH.....XXX--------X....X..X----------------------------X...H.X...H..XX.E..................X
X....E..XX...XXXXXX---------X....E.E..EX-------X.H..X..X---------------------------X:.H...E.....XX..........XXXXXX....X-
X.....X.X...X---------------X...........X------X.......X---------------------------X...........X--X.....XXXX------XXXX--
-XX...XX.X..X--------------X....X.H.....X------X.......X--------X--------XXXXX----X...X.......X----X......X-------------
---XX.X.....X--------------X..XXX..XX...X-------XA.....X-XXXXXXX.X------X.E...X----XXXX..XXXX.X----X.E....X-X-----------
-----X-XXXXX----------------XX---XX--XH.XX------X.....X-X...H..B..XXXXXXX...A.X-------X..X---X-----X.......X.X----------
------------------------------------X.....X-----X......XX.............H..E.....XXX----X..XXX------X.H........X----------
------------------------------------X...XX-----X....X...........XX.XXXXXX..A..E...X---X.E...X-----X.....XXXXX-----------
------------------------------------X..X--------XXXX-X...X..H......X----X.........X---X.....X-----XH.X..X---------------
---------------X----------------XXXX..X---------------XXXX.........X-XXXXH....EXXX-----XXXXBX-X---X.X-XX----------------
-------------XX.X--------------X..H...X-----------------X..H.....BX-X.........X------------X-X.XXX..X-------------------
------------X....X--------------X.....X-----------------X..........X..........X-------------XX....E.X-------------------
-----------X...XX-------XX------X.....X-----------------X......E..............HX-----------X.......X---------------XXXX-
----------X...XXX------X..XXXXXX.E....X--------XX-------X....E.X.............XX------------X.......X--------------X...:X
----------X..H...XXXX--X............E.X-------X..X-------X.........E.....E..X---------------X......X--------------X...X-
-----------XXX.......X--XXXXXXXX......XXXX----X...X-------XXXX...E...X.E....X----------------X..XXX---------------X...X-
--------------XXA....X---------X.E.:......X---X...X---------X........X...XXX------X----------X..X-XX--------------X....X
----------------XXX..X---------X..........X----X..X---------X..H.....X....E.XXXXXXBX--------XX..XX..X-------------X..XX-
------------------X..X-------XXX...A......X----X...XXXX-----X.............X....E...X-------X........X----------XX-X....X
--------------XX--X..X------X...........X.XXXXXX.....:.XXX--X.......X....X-X.......XXXXX---X....H.XX----------X.WX.....X
------------XX..X-X.X-------X...........:.........:.......XX.....E.......X-X....X...E...X--X....XX-----------X.....H...X
-----------X..AX--XEX-------X......A..X..................................X-X..E........X----XX..X------------X.........X
------------X..X--X.X--------XXXXXXXXX-XXX.HXXX..........H..XXX...........X......H.XXXX---X--X..X-----------X......X..:X
-------------X.X--X.X---------------------XX---X.EXXXXX.....X-X...H.......XH.......XXX---X.XXX..X-----------X....XX-X..X
-------------X.X--X.X--------------------------X.X-----X....X-X......H................XXX.......X-----------X.....X--X.X
-------------X..XXX.X---------------------------X-------X...X-X....XXXXXX.......E...............X-----------X....X----X-
-------------XE.....X-----------------------------------X...X-X.....H...X..................E....X-----------XB..X-------
-------------X......X---------------------------XX-XXXXXX....X..........XX.....................X-----------X..XX--------
-------------X..XXXHX----------------------XXXXX..X..:......X..........E....X..................X-----------X..X-------X-
--------XXXXXX..X-X.X---------------------XH...H..X....X..........X..X.....X-X.........H.......X-----------X..XXXXXXXX.X
-----XXX.......X--X.XXXXX------------X-XX-X.......X..........:....X.X-XXEXX--X..............E..X------------X..........X
---XXH........X---X......X----------X.X..XA....H.....................XX-X----X.....X.....EXX...XXXXXX------X..XX.......X
--X.....XXXXXX----X......X--X-------X..............E..........E.A......X---XXX.A..XX..H..X-XXX.......XXXXXX..X--XXXXXXX-
--X....X-----------XXXX..XXX.XXXXXXX.XX....A....A.....E.......XXX....E.X--X.E...XX-X......X.......:...........XXXXX-----
--X...X---------------X.......H..........XXX.........X......X.X--X.....X---X...X---X......X..E..........E..E.......X----
--X....X---------------XXXXX.......E.E.XX--X.........E.......X----XE...X--X....X---X....E.X......A.................X----
-X.....X--------------------XXX.........X--X....X......X......X---X....XX-X.....XX-X..XX.X.........................X----
-XX.....XXX--X-----------------XXXXXXXXX---X.....XX...........X----X.....XX.......X-XX-X.XX...E........E...........X----
X.XX..E....XX.X---------------------------XX....X-XX..........XXX--X.H..X--XXX..XX-----X.XX....X....H.............E.X---
X.........XXX.XXXXXXX------------------XXX......HX......X........X-X....XX----X.X-------X-X.............H.XXE...XXX..X--
X....H...............X----------------X.................XX.......X-X...E..X---X:X---------X.......XXXXXXXX-X...X--X.X---
-XXXXXXXXX..EX......X-----------------XE..............H.XX..H....XX.......X---X..X------XX.......X---------X...X--X.X---
----------XXX-XXXXXX-----------------XX...........:......X......X--XXXXXXX---XX...X----X......X.HX---------X...XXX..X---
------------------------------------X.......H...A.XXXXXXX-XXX.HX------------X.....X-----X.E.HX-XX----------X.......:X---
------------------------------------X...H........X--------XXX..X-----------X...XE.X-----X....X-----------XX.....E...X---
-------------------------------------XXXXXXXX...X-----XX-X.....X------------XXXX..X------X.E.X----------X...........X---
-X------------------XXXXX--------------------X..X----X..X.....X----------------X..XXXXXXX..XX-----------X...XX....:.X---
X.X----------------X.....X--------------------XX-----X..A.....X----------------X....H...XXX-------------X...........X---
X.X----------X------X....X---------------------------X....XXXX------------------XXE.....X---------------X...........X---
X..X--------X.XXXXXXX...H.XX--------------------------XXXX------------------------XXXX...X--------------X...E..H.XXX----
X...XXXXX---X....E.E........X--XXXX---------------------------------------------------X..EX-------------XH.......X------
-X......EXXX.H..XXXX..X.....XXX....X--------------------------------------------------X....XXXXXXXXXX---X.........XXX---
-X...........XXX----X.X........H...XXXXXXX--------------------------------------------X............E.X--X...........EX--
-X...........X------X.X......H.X...X......XXX-----------------------------------------X......:.......X--X.........XX.X--
-X....E.....E.X---XX..X..A.........X..XXXE..EX-----------------------------------------XXXXXXXXXXXXXX---X.EXXXXX.X--X---
--X...........X--X....X..............X---X....XXXXX-----------------------------------------------------X.X-----X-------
--X.......A.X.X-X...A.......XXX......X----X.......EX---------------------------------------------------X..XXXX--XX-X----
-XE.........XX-XXX.........X---XXXXXX-----X....E...X--------------------------------------------------X.......XXH.X.X---
-X...........XX............X---------------X.XXXXXX-X--------------------------------------------------XX....X--X....X--
-X......H.XXX-X.....E......X---------------X..X----X.X--------------------------------------------------X...X---X.XX.X--
-X.......X---XX............X------XXXXXXXXXX..X----X.X-XXX----------------------------------------------X...XX-XXXXX.XX-
-XH...XXX---X.............AX-----X....E.....H.X--XX...X...X-----------------------XX---------X-----------X....X......A.X
-X...X------X..H..E.........XX---X..E....XXXXX--X.........X--------------------XXX..XXXX----X.X----------X....H........X
-XH.AXXXXXXXX...XX............X--X......X--------X:....X..XXXX----------------X....:...EXXXXX.X----------X....X........X
-X.............X--XE..........X---XXXXX.X---------XXXXX-X..E..X---------------X...............X----------X...XX.......X-
--X..........XX--X........A.H.X--------X----------------XH.XXX------X---------X.H....E....XXXX---X-------X...XX...H...X-
--X.....XXXXX---X.H....H.....X----------------X-------X-X..X-------X.X--------X...XX.....X------X.X--XXXXXE..XX........X
-X......X--------XXX.XX....E.X----XX---------X.X-----X.XA..XX------X.X---------XXX--X...WX------X.X-X...............XXX-
-X..E...X----------X.XX......XX--XE.X--X----X..X-----X.....X.X--XX-X.X--------------X....X------X..X................X---
X.......X----------X..X......X.X-X..X-X.XX--X.HXXXXXX.........XX..X...X-------------X....X------X.......E.H.......E.X---
XH......X----------X..X......H.XX.W.X-X..EX-X..............A.........X---------------XE..X------X.............:.....X---
X....XXX------------XXX...XX.........X.....X....................XX..X----------------X....X-----XH..................XXXX
X...X------------------X..X-X..................X.....XX...E.....XX...X---------------X.H..X-----X.................E.A...
X...X------------------X..X--XXX...............X....X--X....H......:X-------------X---X..X-----X....XX.................X
X..AX------------------X..X-----XXX.......:.........X---X.........XX-------XXX---X.X--X..X----X....X-X.................X
-XX.X-------XXXXXX----X..X--------X..................XXXX......E..X-------X.H.X-X...XXX..X----X...X--X.................X
---X-------X......X---X...XXX-XXXX..XXH..:.....:..X...............X-----XXXX..X-XE..A...EX---X.XX.X--X.................X
-----------X......X---X..E...X.....X--X..........XX.........E.....X----X.......X.........X---X.XX.X--X...XX.E..........X
-----------X......X---X...X.X-X....X-X..........X--XXX.........XXX-----XH...............X----X.:..X--X...XXX..H........X
-----XXXXXXX......X---XH...AXX......X-XE..E....X------X.H....XX-------X.......:.........X----X....X--X...H............HX
----X..E........E.X---X.......XXXX..X--X.......X------X.....X----------XXXX..............X---X....X--X...........E.....X
----X.............XXXXX.......X---XH.XXH...X...X-----X.....X---------------X.:..XA.:......XXXX....X--X.....B.........XX-
----X..........HX............X---X.............X-----X...E.X------XXXXX---X...........H...........X--X...............X--
----X..........X-X.....E....X-----X.X..E..H..XX------X.....X-XXXXXW....XXX..............XX.XX.....X---X.........H...X-X-
----X.E...A.....X.XXXXX....EX------X-X......X-------X.......X....X..H..............E...X--XX......X---X....XXX..XXXX-X.X
-----XXX...........X---X..XX---------X......X-------X...E...:....XX....................X---X......X----XX.X--X..XX---XHX
----X.......XA.H..X----X.X-----------X......X-------XE.X......EXX--X....H...H.....E....X---X......X------X---X....XXXX.X
----X.........XX..X---XXXXXX------X--X.:.XXHX--------XX-XXXXX...XXX.............H......X----XX...X-----------X..H......X
-XXXXX.....A..XX..X--X..X...X----X.X-X......X----X-----------XE.....H................XX------X....X------XX--X:...A....X
X........:....X-XEX-XXE.....X----X..XX....A.XXXXX.XX---------X................A.......X-XXXXX.E....X----XA.X-X......E..X
-XXXH.........X--X-X....X.E.X---X...XXXX.X........H.XX-------X..............H..........X......XXXXX-----X.X---XXXX.....X
---X...........X--X....X-X..X--X..B....XXX....E.......X------X.E......H....X................E.X---------X.X-------X....X
--X............XX-X.E..X-X..X--X......E..X:.X......E..X------X....E.XXX....X..................X--------X..X-------X....X
---XXXXXX.....B..X..XXX--X..X-X.....XX...X.X-X.........XXXX--X.H..X........................XX.X--------X..XXXXXXXX.....X
--------X..........X-----X..X-X.....XX......X..............XX........H...E.........X......X--X--X------X...H....A...H..X
--------X..........X-----X..X-X.....XX.E..X.......H.............E.........X......H.....E..XXXXXX.X-----X..............X-
--------X..........X----->..X-X..H..XX....X.XXXX.....H...................H.......................X-----X..E....H.....X--
--------X......A.E.X----X...XX......X-XXXX-X----XX..XX...XXX.E.XXX....X..XXXXX.A.....X....E...X.X-------XX.......XXXX---
---------XXXXXXXXXX------XXX--XXXXXX--------------XX--XXX---XXX---XXXX-XX-----XXXXXXX-XXXXXXXX-X----------XXXXXXX-------
