-XXXXXXXXXXXXX------------------XXXX-XX-----------X-------------------XXXXXXXXXX----XXX-------XX------------------------
X...E.........X----------------X.E..X..X---------X.XXX-X-------------X.....E...HX--X...X-----X..X------XX---------------
X.........H...X----------------X...E...X---------X....X.X--X---------X..........XX-X....XXXXXX..X-----X..X--------------
X..............X--------------X.........X-------X..H.....XX.X--X-----X...E........X.............X-----XE.X--------------
X...A.........X----------------XXXXXXX..X------X.........X..X-X.XXX--X.......BXX....H.X..H.....X------X..X--------------
X.......E.....X----------------------X..X------X.E.......XX.X-X.X..XXX...XXXXX-X.........XXXXXX-----X-X..X--------------
-X.........XXX-----------------------X..X-XXXXXX..........H.XX..........X-------XX.E....X----------XHX...X------------X-
--X...X....X--XXXXX-----------------X...XX..H...........E.X.....XX...E.X----------X..XXX-----------X...XX------------X.X
--X........XXX.....XX---------------X............XX...H..X-XX..X--XXXX.X---XXXX---XHX--------------XE.X--X----------X.HX
---XX..XA...........HX---------------X....XXXXXXX--X....X--XXHX-------X---X....X---X---------------X..X-X.X--------X...X
----X..XXX....H.....X---------------X..E..X-----XXXX.....XX...X-----------X....XXX-----------------X..X-X.X--------XH..X
-----XX---XX.....E..EXX--------------XX...X----X......E...HXX..XXX---------X.H....XXX---------------X..XX.X--------X...X
----------X............X---------------X..X----X....XXXXXX.X-X....X--------X.......A.X--------------X..XX.X-------XX...X
-----------X.....X.:...X----------------XX-----X....X-----XXX...:.X---------X........X--------------X..XX.X------X.....X
-----------X...AX-X....X------------------------X....X----X......X----------X......XX---------------X...H.X------X.....X
-----------X....X-X..X.X-------------------------XXXX-----XH....X-----------X.....XXX---------------X.....X------X.....X
-----------X....X-X..XX------------------------------------X...XXX----------XH.......X--------------X.....X------X.....X
------------XXX.XXE...X------------------XXXXX--------XXXXX-XX.H..X---------X....EXX.X--------------X.....X------X.....X
------------X..........X----------------X.....X----XXX.....XX......X-------X......XX.X-------------X.H.....X-----X..W..X
-X-----------X..XX..E.HX-----------------X....X---X......E......A...X-------XXXXXX-X..X-------XXX-X........X-----X..XXX-
XAX-----XXXXXXEX--X..XXXX-XXXX-----------X...EX--XXA........H......X-XXXX----------X..X---XXXX...XX........X-----X..X---
X..X---X.......X--X..XX..X....X----------X..XX--X.......X...........X....X---------X..X--X.......X........X----XXX..X---
X.XXXXX........X--X..XX........XX---------X:.X--X...A..X-X...............X--------X.H.XX-X.......X........X---X.....X---
X...E..........EXX............H..XX------X...X---X.....EX-X.......E......X------XX......XX...............X----X....X----
X......XXXX..:.....E...............X-----X...X--X........X..XXXXXXXX...A.X-----X..H.....XX........A.....X-XXXX..XXX-----
-XXXXXX---X...X...XXX.........XXX..XXXXXXX...X--X............XXXX........X------X.......X......XXXXXXXXX-X......X-----X-
----------X..XX....XX......E..X-X.E......E...X--X......E.................X----XX...XXXXX-XE..XX---------X...H.XX-----X.X
---------X-X.......H.XXX......X-X............X--X..........A..............X--X....X------X..X---------XX.....X-------X.X
--XXXX-XXEXX........X--X.......XX.XXX.........XXX................X..XX...E.XX......XXX-XXX...X-------X.......X-------X.X
-X....XE..X-X........XX.......E...HX...E........H.EXXXXXXX.X....EX...X................X......X-------X.......X-------X.X
-X........X--X..........H.XXXX.......A......XX....X------X...H.......................E.......X-------XE......X--XXXXX..X
-X........X--X.H...H..AXXX-X....XXXXXXXXH....XXXXX-------X.XXX.......XX..E.......E............X------X.......X-X....H..X
X.........X--X.........X---X...HX------X.....X------------X---XXXX...XX....XE................H.X-----X..E.....XX......EX
X.E..H....X--X.......XX----X.XXX-------X..XXX--------------------X....X.........................X----X.....XX.XX..X....X
X.......:.X--X....H.X------XX-----------X..XX--------------------X.......XX....E................X----X....X-X.XX..X....X
X.H....XXX---X.....X-----XX.X----XXXXX--X...HX-------------------X........X...............X.....X----X.....XH....H.....X
X.....X----XX.......XXXXX...HXX-XE...HX--X...X--------------------X..............E........XX.....X----X................X
X..X..XXXXX.H..E...............XX...X.X---X..HXX------------------X.E.......H.......E............X----X......XXX..H....X
X..X.E.......................XX........XX-X.....X------------------X..............A.....H........XX---X....EX---X.....X-
X............X..........XXXX.X-XX.....E..X......XXXXX---------------X.....E..X..E.....:............X---X...X----X.....X-
X.A..........X..E......X--X...XE.....................XXXXX----------X.......XX.............E......AX----X..X----X..A..X-
X......................X--X..H........E...............:...X---------XH......XXE.....E.....XXXXX....X----X..X-----XXXXX--
X..................XXXX---X.............XXX...XXXXXXX.....X----------X......X-X...........X--X.....X----X.H.XXX---------
X.XX.H............X------X..............X-X...X------X..XX------------X.....X--X.H.......X--X.......X---X......X--------
-X--XX......A...:.X-----X..H.............X...X--XXXXXX..X--------------X....X--X....XXXXX----XX..E..X---X...XXXX-----XX-
------X...A.....X..X----X....E....XXXXXXX-XXX--X........X---------------X...X-X....X----------X......X--X....XE.XXXXX..X
-----X.........AX..X--XXX.........X------------X........X----------------X..X-X.....XX---------XX.....XX............E..X
-----X........XXX.EX-X............X-------------XXXX..H.X-----------------X.X--X......X----------X...E..E......XX......X
------X.X.A...X-X..X--X..XXXH......X----------------X...X------------------X--X....XXX-----------X...........XX-X...E.EX
-------X-X....X-X..X--X...X-X.E....X-----------------XE.X---------------------X..XX---------X----X..........:.X-X......X
----------X....XH.:X--X...XX........XX----------------X.X---------------------X..XXXXXXX---X:X----XXX.....XXXX--X...XXX-
----------X........X---X.EXX.E...H....X--------XX---X--X----------------------X.........XX-X..X------X.....X---X...X----
----------X......H.X---X.XX-XX.:.....:X----XXXXH.XXX.X------------------------X.....H.....XXE..X-----X......XXX....XX---
----------X........X----XX.X-X........X---XE.......X.X------------------------X..XXXXXXXX.XX...X-----X..H............XX-
----------X........X---XXX.X--XX...E..X---X..........X-----------------------XX.X------X-X-X....XXXXXX.....XX:......XX.X
----------X.......AX--X....X----X.....X---X:.X...E.XXX----------------------X...X-----X.XXX.E........X....EXX...E......X
---------X.........X--X....X----X.....X--X...XXXX..X..X---------------------X...X----X..........:..........XX...X......X
---------X.........X--X.E..X---X.E...X---X............X----------------XXXXXX..X----X.................XXX..X-XXX-X...A.X
---------X......E..X--X...:X---X.....X--X.............X-------------XXX........X----X.......E.....H.XX---X.X----X......X
--------X....H....X.XX.:.X.X--X......X-X.H.HXE....XXXX-------------X..X.......X-----X...............X----X.X----XH....:X
-------XX...........X-X.X-X---XA....E.XX....XX...X------------------X.........EX----X..XXXXXXXXXX...X-----X-----X......X
----XXXH.........E.X-XX.X------XXXXX..X:....X-XXX-------------------X...........X---X..X--------X...X-----------X......X
---X................X...X----------X........X-----------------------X...E.XXXXXX----X..X--------X:..X------------XX....X
---X.....................X---------X...XX.H.X------------X-----------XXXXX----------X..X--------X...X-------------X....X
---X..........H..X....X..X----------XXX--X..X---------XXX.X-------------------------X..X---------X.X-------------X.....X
---XH.X.......XXXX..XXX.EX---------------XH.X--------X..H.X-------------------------X..X---------X.X-----XX------X.....X
----XX-X...E...XXX.X--X..XXXXX------------X.X---XXX-X..XXX------------------------XXX..X----------X-----X..X-----X.....X
--------X..........X--X.......X-----------X.X--X...XX..X-------------------------X...H.X----------------X...X----XE....X
-------X......XXXXX----XX.....X-----------X..XXE......XXX-----------------------X...X...X-------------XX....X----X....HX
--------XX....XX---------X.....X----------X..............X-----------------------XXX-XXX----------XXXX......X-XXX......X
----------X.....X-------X.....X-----------X..............X---------------------------------------X..........XX...E...X.X
----------X.....X-------X.....X-----X-XX---X.XXX.........X----------XXXXXX----------------------X.E..XX.E....H.......XX-
-------XXX.......X------X...X..XXXXX.X..XX--X--X.........X---------X......XX-------------------X....X--XXX.......H..X---
------XH.....X....X-----X:...........H....X----X.B...X...X---------X........XXX---------------X.....X----X...:......X---
-------X.....X...X------X....E..........H.X----X....X-X..X---------X..XXX...H..X--------------X<....HXXXX...........X---
-------X.....XEXX-------X..A............XX-----X..E.XX...X---------X..X--XX....X--------------X............X....X..EX---
-------X....X-X---------X..X......H.E..X-------X..XX-X.E.X---------X..X----XXXX---------------X...........:XXXXX-X..X---
-------X.XXX------------X..E.XX.........XXXX---X.X---X.X.X-----XXX-X..X------------------------XXXXX...:.XX-----X...X---
-------X.X---------------X.......XX.:.XXX...X---X-----X..X----X...X...X----------------------------X..XXX-------X..X----
------X..X----------XXX--X...X...X-X..X-X....XX------X-X.X----X.......X-----------------------------XX-----------XX-----
-------XX------XXX-X...X--X..XXXX--X..X--X....EX----X.X-X----X..H.....X-------------------------------------------------
-------------XX...X-X...XX..EX------XX--X..H...XXXXX.EX------X......H.X-------------------------------------------------
------------X....X--X.......X----XXX----X....X........X------X....:...X------------------------------XXXXXX-------------
------------X...X---X.......X---X...X---X..:.X......XX-------X........X-------------------------XXXXX......XX---X-------
------XXXXX-X..X----X....E..X---X....XXXH....X..E..XX--------X.........XXXX---X--X-------------X.........E..HX-X.X------
-X---X.....X..X---X-X.......X---X...XX.....X.X......AX------XE.........X..HXXX.XX.XX-----------X.......XX.....X..X------
X.XXX.A.....:.XX-X.X....XE..X----X:.XE.E..X-X-X...A..X-------X..H.....X-X...........X----------X.X....X--XX.....EX------
X..A.X..........X......X-X..X----X..X.....X-XX......X--------X:....H.:X-X.E........X------------>-X...X----X......X-----
X....XA...........XXXX.X-X.H.X---X....E..H.X......:.X--------X........X-X.XX.H.....X--------------X...X----X......X-----
X.B...........X..X--XX.XX....HX-X.......X.X-X.......X--------X....XXXX--X....XXX...X--------------X..HX----X.....E.X----
X....XXX......X...XX.......E..X-X.....XXA.X-X......E.X-------X...X------X....X-X...X---------------XXX-----XA....XX-----
X....X--X.....X....H..........EX.E......X.X-X.........X-----X....X------X....X-X...X-----------------------X.....X------
X.X..X--X...XX-X.......X.............XXX-X.X.E.........X---X....HX--XXXX...:.X-X...X-----------------------X..H..X------
X.X..X-X....XXX.......X-X...........X----X.............X---X.....X-X..........X....X------------------XX--XH.....X------
X.X..X-X...E..........X-X...........X----X...E....E..XX.XXX.......XX......XXXXX....X-----------------X..X-X......X------
XAX..X-X.....X...E...X-XE....XXX....XXXXXX...........XX..................X--X......X-----------------X..X-X.......XX----
X....XX.........X....X--X...X---X...H.............H..XX..........H........XX....A..X-----------------X..X-XE...H....X---
-XXH.XX.........XXXH.X--X..X---X.XX..........E..........XX...........E.............X-----------------X..X--X........X---
--X.X--XX..E...X---X.X--X..X--X..X-XX...........H......X-X....H........H........:...X-----------XXXXXX.H.X-XH.......X---
-X..X--X.....X..X-X...X--XX--X...XX-XA.................X-XE........H...X...XX.......X----------X..H......X--X......HX---
XH..X--X....X-XX---XXX---X---XA..X.X-X....XX..E.E..XX..X-X.............XX.X--X.A....X-------XXX..........X--X...A...X---
X..X---X.....X.X-------XX.XXX....H.X-X.........XXXX--X.X-X.......H.....X..X-X.....:..XXXXXXX............EX--X.......XXX-
X...XX-X..EXXX.X-----XX.......XX...X-X...H.XXXX-----X..X-X.X...........XX.X-X...H....E................X..X-X..X.:......X
-X....X....X.XEX----X.........X.....X.....X--------X...X--XXE..........XX.X--XX..........XXEX....X...X-X.X-X:.X.....XXX-
-X...A.........X----X.........XX.........X---------X...X--X.X..........XX.X----X.........X-X-X.......X-X.X--XX......X---
--XX.XX.........X---X...XX.H.X--X...H....X---------X....XX..X.XXX.XXXXX-X.X----X.AXX......X.X-X......X-X.X----X..E..X---
----X-X..........XXX....E....X--X........X---------X...H.....X---X---XXX..X----X.X--X:.......X........XX..X----X....X---
---X.X....EXXXE.A............X--X.......EX-------XX.E........X------X.....X----X..XX...................H...XXXX....X----
-XX.E......X-X..........A....X--XXXXXX...X------X...........X--------XX..X-----X.H.........................A........XX--
X..........X-X.............A.XXX.X---X...X------X............X---------X.X-----X......H.A.....................B.......X-
X......E..EX-X.............X......XXX.....X-----X.....H.......X--------X.X----X............X.............X............X-
X..........X-X..........EXX...H....E.E.....X----XE..A........X---------X.X----X........:...X......E...X.X-XX......E...X-
-X....XXXXX--X.XX.......X--X................XXXX.............X----------X-----XE...........H...........X---X...E.....H.X
X.....X-------X-X..H.....X-X.XXE...........E.......E..X...E..X----------------X..X....XXXXXX.XX.....XXXX---X..XX.E.....X
X...X.X---------X.......H.X.XXX.....E................X-X.....X---------X---XXXX..X...X------X-X.........X-X...X........X
-X..XX----------X....E..........XXXX...........E.....X-X.....X-----XXXX.XXX.H........X--------X....XXXXX--X....:.......X
-X..X-----------X...........E.EX----XAXX.H..XXX..XXH..X...AX.X---XX..H.......XXHXX..X----------X..H.X------X...........X
--XX------------X...............X---X..E...X---XX--X..XXXXX-X---X.E.........X--X-XE.XX----XXXXX.....X-------X..........X
-----------------X...............X--X.XXX..X------X..X----------X....XXXXXXX-----X....X--X..H...E..X---------X........HX
------------------XXXXXXXXXXXXXXX----X---XX--------XX------------XXXX-------------XXXX----XXXXXXXXX-----------XXXXXXXXX-
