--XXX---------XXX-----XXXXXXXXXXXXXXXXXXXXXXXXXXXXXXXXXX---------XXX-----------------------------XXXXXXXXXXXXXXX--------
-X.A.X-------X...X---X......:...........................X-------X...X---------------------------X...............X-------
X.....X------X..X-----XX..H..XX....X...E......X.XX......X-------X..HX---------------------------X.H......XXXXXXX--------
XA....X---XXXX..X--X----XXXXEX-X..X-X...X....X-X--XXX..X--------X...X---------------------------X..XX.H.X---------------
X......X-XH.EX..XXXEXXXX---X..X....X.H.X-X....X-----X..X-------X....X---------------------------X..XX...X---------------
X......X-X...X..........XXX............X-X....XX-----XX--X-----X..H.X---------------------------XX..X....X--------XXXXX-
-X....X---X...XXX...................E..X-X......X-----XXX.X----XX...X--------------------------X....XXXXX--X-----X.:...X
--X...XXXX.H.X---X.......H..XXXXXXXXXXX--X.....HX----X....X---X.....X--------------------------X...X-XXX--X.X----X....X-
--X.H........X---X..E........X------------X..XXX-----X....X----X....X--------------------------X...XX...XX...XXXXX...X--
--X.........X----X..X....E....XXXXX-------X.HX-----XXX....X---X.....X------XX-----------------X.............H.......X---
-X-XE...E...X----X.X-XE.XX.........X------X...XX--X.......X--X.H.....XXXXXX..XXX---------------XXXXE.E....X.X...:..X----
X.X.........X----X.X-X.............X------X.....XX........X--X......H.........E.X------------------XX.....XX-XXXXXX-----
X..H.........XXXX..XXX.............X------X...........XXX..XXA..............X...X-------------------X....X--------------
X..................X............E..X-------X.........E.XXE.E......X..A.....XX...X-------------------X....X--------------
X.........EX....E.......E.H.........XX------XX........X-X......XX.X........XX...X-------------------X....XXXX-----------
X...:.................................X------X.....A..X-X......XX.X.........XXXX--------------------X........X----------
X...X............XX....................XX--XXX.........XA.......X.X.......XX---------------------XXXA.......:X----------
X.X.X.XX.........X-X..X.A.......A........XX............X..........X.H....X----------------------X.....H......X----------
X...X.XX.......H.X-X.X-X....E..X..:.....X--X...........X.................X----------------------X.........XXX-----------
-X.X..XX........XX-X.X-XE.....E.H...X..X----X....X..A....B..H...........X---------------------XXX.....A..X--------------
-X.X...X...X...XX.X..X-X...........X-XX-----X....X.....X...............X----------------XXXXXX.H......XX.X--------------
-X..XX.X....X........X-X...........XX.X-----X.H.XX....X-X.A..HX......EX-----------XXXXXX.............X--X----XXX--------
--XX--XX..XX-XX..H...X-X....A....H....X----X.........X---X...X..E.E.XX-----------X....H..............X-X.X--X...X-------
-X-----X..X----X...E.X--XX.X..:XX......X---X.........X---X..X-XXX...X------------X............E..XXX.HX.WX--X..:.X------
XEX----X..XXXXXX.A...X---X.X:...XXXXX...X--X.H...H....X---XX---XX....X------------XXXX.........XX---X.....XX......X-----
X.X----XH......X.....X--XX.X...X----X.H.X--X..........X-------X.......X---------XX---X..........X--X...............X----
X..XX--X......XX.....X-X...X...X----X.XX---XE......XX:X--XX---X.......X--------X..X--X...E......XXX...E.........X.X-----
X....XXXE..H.X-X......XX..XX....X----X-----X.......XX..XX..XXX.E......X--------X.H.XX.........................XX-XX--XX-
X...E........XX-XXXXXX--XX--X...X----------XH...H..X.................X--------X.....E..XX..XXXXX............EX---XHXX..X
X........XXX...X------------X...XXXXX------X.......X..X..............X---------X.......XX.X----X..E.A.........XX-X...HX-
X..XXXXXX--X...X------------X..HX.E..XX----X.H....:.XX-X....E.....E...XX-------X.......X.X-----X..........E.....X.....X-
X..X--------XH.X------------X..X-XX....XXXXX.......X--X.H...........X...X------XE.........X-----XX.........XXXE.A.....X-
X..X--------X.X-------------X..X---X.......XXXXXXXX---X.................X------X..........X-------X.......X--X.....E.X--
X.X----------X----X----XX---X...X--X...E..X--XXX------X..X....H.X.....E.X------X..E.......X-------X...E.E..XX.......X---
-X---------------X.XX-X..X--X...X--X......X-X...X-----X.X-X.............X-------X.........X-------X......XX--XXX..XX----
-----------------X...XX..X--X...EXXX.......XX...X-----XX.X-X...X..X....X-------X.......E..X----XX-X.....X------X...X----
------------------X......X--X..........:....X...X---XX.X.XX.....XXX.....XX-----XE.........XXXXX..XH...H.X-------XXX-----
------------------X.H....X---XXXXX...........A.A.XXX.....XX.....XX.......:XXXXXXX..........E....H........X--------------
-------------------XX.....XXXXXXX..........H............X..X..................A....E......................X-------------
---------------------X...............E...........E.....XX..............XX........................:..H..H.X--------------
---------------------X....................W....:.........E...X.....H..HX.........XXXXXX............X...XX---------------
----------------XX---X..E.........................E...E..XXXXXE.XXXXX..X..E....EX-----X.....X...E.X-X.X-----------------
---------------XH.X---X..XX.....E.......H..............XX-----X.X-XX-X.....XX...X------X...X-XX..X---X------------------
---------------X..X--X..X--X......................X....X-------X-X..X-X...X--X..X-----X..E.X--X.X-----------------------
---------------X..X--X..XXXX...H.......HX..............X--------X...X-X...X-X..X------X.X..X--X.X---------------------X-
--------------X..X----XXX..........X.H...............XX---------X...XX..XX---X.X------XX-X.X---X------XXXX----------XX<X
-------------X....XXXX..E.E.....A.X-X...XX.......E..X-----------X..HX..X-----X.X---XXX.X-X.X--X.XXXXXX....X--------X..HX
-------------X......H.......H....XXXXXX.XX..........X-----------X.......X-----X---X.....X..X--X.....E..E.HX--------X...X
--X--------XXH......X.......XXXX.XE......X....X..E..X-----------X......HX--------XXXX.....X---X...........X--------X...X
-X.X------X........X-X.....X----XX....H..X..E.XX....X-----XX-----X.XXX..X-------X......XXX.X--X...XX.....X---------X..:X
-X.X-------X..H.....XX.....:XXXX........:...........X--XXX.:X-----X---X.X------X.......H...EX-XE.X--XXXXX--X------X....X
X..X-------X........XX.....................X.......E.XX.....X---------X.X-XX---X............X-X..X--------X.XX---X.....X
X..X---X---X........XX...XXXX...H...E.....X-XXXXX............X-------XX..X..X-XE..X......XX.X-X..X--------X...XXX.E...X-
X..X--X.XXX.........XX.XX---X.....EXX....X-------XXXXXXXX....X------X...X-X..XX....X....AX-X--X..X-------X............X-
X.AX--X................X----X........H....XXXXXXXXXX----X.....X------X..XX...XX.XXX-X....X-----XAXXXX----XX....E.....HX-
X..X--X..H.........E...EX--X.......X......E....H....XXXX...A..X------X..........X---X....XX---X......X--XHXXXX.......X--
XE.XX-X..........XXXX....XXX.......X...XXX........X......XXXXX-------X...E...X..X---X..X...X-X.H....EX--X.X---X.......X-
X....XX........XX----X...X...H.....X..X---XXXXXXXX-X..E.X------------X.....E..E.X-XX.HX-X..X-X.....XX-XX..X---XA......X-
X....XX..E...XX-----X....XXX....EXXX..X--------X:.X......X------X----X.A........XX..X..X..EX-X....X--X.X..X--X...E....X-
X....XX.....X-X-----XE..XX........X..XX---------X.....:...X----X.XX--X...XX.....XX..X......X-X..HX---X....X-X..........X
X....XX.....XX.X--X--X..H........XX....X-----X--X..........X---X...X--X.X--X....XX..XA...XX--X...X---XH....X.....A.....X
X....XX..E.....EXX.X--X.....XX.HX-X....X----X.XXX.....H.....XXX..XX---X.X--X...XXE.....XXX---X.EXX---X.................X
X..:.XXE.......X.E.XXX.....X--XX--X...HX----X.........XXX........X---XE..XX...X-X..E......X--X...HX-XH...E.XXXXXXXXX...X
X.......XX...W.X......H....X------X.....XXXX...XXXX.XX---XE..:..X----X..X--XX.X-X........X.X-X.H...XX......X--------X..X
XE...XXX--XE...X...........X-----X......E......X---X-----X...XXX------XX-----X---X.......X.X-X...XX--X.....X-------X...X
X..XX----X......E.......X.X------X..XXXX.....H.XXX-------XXXX--------------------X.........XXX.:.X--X.......XXXXXXX....X
X..X------X..E......H...X.X------X..X---X.........X-----X.X---XX-----------------X................XX........H.....X....X
X..XXXX---X..X............X------X..X-XX.....X.E.X-----X...X-X..X---------------X.........X........E...........XXXA.A..X
X......XXX..XXH...E.E.....X-------X.XX.....H.....X--XXX....XX...X---------------X:.....H....XX........XXX......X--X....X
X.E...XXH.H.X-X...........X-------X.XX...........X-X............X----------------X...:......XX...XXXXX--X....:.X-X....X-
X...E.XX...X--X...XX.X..XX-------X..XX.....XX.H..XX...E.E.H...XX-----------------X.XXXXXXXH.EXXXX-------X......X-X...X--
-XX..X-X...XXX.......XXX----------XX-X....X--XXXXX.........XXX--X-----XXXXXXXXXXXXX-------XXX-----------X......X-X...X--
-XX.X--X..E..........X---------------X....X------X.......XX----X.XX--X............X----------------------XX....X-X..HX--
X...X--X.............X----------------X.XX-------XE.....X------X..HX-X..E......E...X-----------------------XXXX---XXX---
X....XX........XXX....X-----X----------X----------X.X....X----XX...X-X..X....X.....HXXXXXXX-----------------------------
X..................A..X----X.X--------------------XX......X--X.....X-X..XX.A.X.............X-------------X--------------
X........:............X----X.X------------------XX....A..X--X...HXE.XX.......X....H........X----XX------X.X-------------
X.....................X-XXXX.X----------------XX........X---X.....XX--X.........H........X.X---X..X-----X.EXX-----------
X..E................HX-X......X--------------X.....H....XXXX......X---X.....H..............X----X.X-----X....X----------
X...XX.....H........XXXA.......X-----------XXX......XX............X----X..XXXX.............X----XEX-----X..H.X----------
-XXX--X.............X.........X--XXX------X......XXX--X............XX--XE..X-XE....H.......X----X.X-----X.....XX--------
------X....E.............E...HX-X...X---XXX.......X---X.......H......X-X..EX-X.........XXX.XXXXX..X-----X......HX-------
---XXX.E..........H.H.........X-X....X-X..XH......XXXX.....E.XX....H.X--XXX.XX...H....X---X.H.....X-----X...X:..X-------
--X...XX......................X-X.....X.........XA..........X-X......X---X............XXXX........X-X---X.......X-------
--X......XX......:.A........E..X.....E.........X-X......X.E.EX.......X--X:......................XX-X.X--XA..H.A.X-------
--X:.E..X--X........XX....................H....X--XX.A..........H....XXX.....XXX..............XXX--X..X-X.....XX-XX-----
-XXX....X-X.........X-X...............X........XXX-X...HXX....H......E....X..X-X..E...E.E........XX....X.....X--X..X----
X.H.....X-X...H.....:X.............XA.X...........X....X--XX.................X--XX....XXX..............X..XXX----X.X----
X..X...X---X..........E...........E...XX.......E...E...X---XX............XXXX-----XXXX---X.................X-----X.X----
X......EXX--X..........X.:.E..........XX..A..........HX---X............XX----------------X..H............XX------X..XX--
X....E....X-X.........X-X..............X..............X---X............X-XX---------------X.....XX....HXXXX--XXXX.....X-
-X........X-X.........XX..A.......X.........XXX......X----X..........E..X..X--------------X.XX......XXX-X..XX..........X
--XX....H.XX............H........H..XX.....X---X....EX----X.................X----XXXX------X-X.....X----X..XX..E.......X
----X....X-X........................XX......XXXX....X------X............XX..XXXXX....X--------XE...XXXXXH..XX.XX.......X
---X.:...X-X..........E.........H.................XX--------XXXXXXXXXX..XX...:.......X---------X...........XX..XXXXXX..X
----XXXX.X--X........X............E...........HXXX--------------------X.X-X..........X--XX-----X.......:...XX..X-----X.X
--------X---X.........E......H..X.X........X..X------------------------X--X......XH...XX..X----X...E....XXX-X.EX------X-
------------X....E..............X.X......XXE..X----------------------------X....X-X.......X----X.......X----X..XXXXX----
-----------X........AX........XE...A...:.....X------------------XXX---X-----XXXX-X.......X-----X......X---XX...E....X---
-XX----XXX-XE.......X-X......X-XXXX.......H..X-----------------X...XXX.X---------X..XX..X------X...BXXXXXX.E.....X...X--
X..XXXX...X.......XX--X...X..X----X...........XX---------------X.....:.X---------X..X-XX-------X.....X..........X-X.X---
X........X..W.....X--X.:..X..X----X.............XXXXXX----------XX......X--------X...X---------X.H........A......X-X--X-
X...H...X-X....E...XX....X-X..X---X.....X.............X-X-X------X.......X-------X....X---------X...XX...........X-X-X.X
X........X...H.......X....X...:X--X.....X...E.....A..X-X.X.X----XXX..EX..X--------X...X---------X..EXX.H......E...X.X..X
X...E.H...E......E..X-XXXX-XX.X---X...............XXX-X....X---X.....X-X.X---------X.X----------X...XX....E.........A..X
X...................X--------X---X........E....EXX----X...X-----X....X--X.X--------X..X---------X.XX--XX......H........X
X.....XX.............X------------X.XX.H.......X------X...X------XXX..XX..XXX------X..X----------X--XX-X...X........H..X
X....X--XX....E.....E.X------------X-X.........X-XX---X....XXX------X........X-----X..XXXXX--------X..X....X..XX.......X
X..XX-----XXXXX..E.....XXX-------X---X..........X..XXXX.E.....X--XXX.........X-----X.......X--------X......X..XXH......X
X..X-----------X.....:.E..X-----X.X--X..........X.A...........X-X.........H..XXXXX--X...E..X------XXX...XXX-XX-X.......X
X..X----------X.H.........X----X...X-X.........HX..........H..X--X...............EX-X.....EXX----X......X------X.E.....X
XE.X----------X.........XX-----X....X...........X...XX........X--X................X--X.......X---X...XX.XXX----X......EX
X..X----------X....:...X------X.......X........A.W.X-XH....E..X--X..E.XXXX...X....X---XX....X--XX...X--X...X--X..X.....X
-X.X----------X........X------X..E........XXXXX.....XX........X---X..X----X.X-X....XXX-X....X-X.H...HX--X...X-X.X-X....X
-X.X-----------X.:.....X------XX...XXX.XXX-----X.....X......XX-----X.X-----X--X.....H.XX...X--X......X---X...XX.X--XX..X
-X..XXXXXXX---X........X----XX.....X-XX--------X.E...X.....X-------X..X-------X..........E.X---XXXXX.X---X...E..X----X.X
-X.........X-X..E.....X----X........X.X--------X....XX..:..X--------XX--------X............X--------X----X.A...X-----X.X
-X..A....A.X-X..X....X-----X....H.....X---------XXX.XX....HX------------------X............X------>XXXXXXX.....X------X-
-X..........X.....E..X-----X.....X.A..X------------X-X..XX.X------------------X......XXX....X----X............X---------
--XXXXXXXXXX-XXXXXXXX-------XXXXX-XXXX----------------XX--X--------------------XXXXXX---XXXX------XXXXX...XXXX----------
