-XXX--XX----------------XXXXX-----XXXXXXX--XXX---------XXXXXXXXX------------------X---------------XXXX----XX------------
X...XX..X--------------X....HX-XXX....E..XX...X-------X....H....X----------------X.XX----XXXXXX--X....X--X..X-----------
X.......X-------------X....XX-X.E...........XX----X---X........X-----------------X...XXXXH.....X-X...AX--X..X-----------
X..:...X--------------X....XXXX...........EX-----X.XXX..XX.....X------------------XH.E.........XXX.....XXX..X-----------
-X....X--------------X..X.E......H..........XXXXXX......X-X....X------------------X.........E............:..X-----------
-X..XX---------------X..XX.......................XH.E..X--X....X-------------------X...........X..H.E.......X-----------
-X..X-----------------XX--XXXX......H...XX............XXXX..XXX-----XXX-------------X........XXX............X-----------
-X..X-XX---------------------X.........X-X....X............X-------X.E.X----------XX........X--X..A........HX-----------
-X..XX..XX-------------------X..........X..............:...X------X....X-XX-----XX........XX---X............X-----------
X...XX..E.X------------XX----X........E.A..............XXXX-------X...:.XE.XXXXX..E......X-----X......XX....X--------X--
X.........X-----------XA.X--X...................X...H.AX--------XXX....................EX--XXXX.......XX.....X-XX---X.X-
X......XXX------------X..X--X..............:...........X-------X.....:XX.....E..........X-X..A....H...........X.HX-X...X
X...XXX------XXXX-----X...XX.............E........E....X-------X.....X--X..H...E.A......X-X....E..................X-X..X
X...XXXXXXXXX....X----X.......XXX..........X...........X------X......X--X....XXX........X-X....................X.X--X..X
X.E..E.....H......X---X......X--X....E.....XXX...H.....X------X......X-X..:XX--X.........XH....E..............X-XXXX...X
X..XXXXXXXX........X---XXXX.XXXXX..........XX...........XX---X.......HX....X---X.A........................XXXXXX.......X
X..X-------X.......X------X....HX..:..:....X-X............X--X............EX----X..H.....H......XX........X.......H...X-
X..X-------X.....XX--------X...X-X......:.X---XX......H...X--X.............X-----X......XXXXXXH.X-X.......X.E.......XX--
-XX-X------X...HX-----------XXX.XXX.......X-----X......X.XXX-X.......XX....X-----X..XXXX-----X..X-X....H........XX.EX---
X..X.X------X....XXXXXX-XXX---XH...X......X-----X......X....X........X-X...X-----X..X--------X..X-X............XXX.X----
X..X.XXXXXXXE..........X...X--X.........H.X----X.......X.....A.E.....X--X...XXX---X.X--------X.X--X....A......XX..X-----
X......................X....X-X...........X---X.........H........X...XXXX......X--X.X--------X.X--X..E...E...X-XH..X----
X.X......:.................X--X...E.......X---X......X.XX.....H..XXX..........HX--X.X--------X.X--X....XX.X..X--XX..X---
X....E....................E.XX...........EX---X.....X-X-X.......X---X.E....H...X--X.X--------X.X--X....AXX-X.X---X..X---
X.X..........HXXXXX.................H......X--X.....X----XXXXXXX----X..XX......X--X.X------XX..X--X....X--X.H.XXXX..X---
X.XX...E....X.X----X......HXX.............X---X.....XX------XX-------XX--X.H...X--X.XX----X....X--X...X---X.........X---
X.XX..........X--XX.XX.....XX.............X---X.......X----X..XX---------X......X-X.H.X--X.:...X--X...X---X.....EXXX----
X..X..........X-X...X-X....XX....E........X----X......X-----X.X.X--------X.......XX...X--X....X.X-X....XXX.......X------
X.XX..........X-X...X-X.E..............H..X----X......X-----X...X---------XXXX...X-XXX---X..X....X...........XXH.X------
-X-X.H..H.....X--X...X-XXX..........E.....EXXXXX......X------X...X-----------X..X-------X..XX...X...H.......X--X.X------
---X..........X---X...X---X........................E..X-------X.X------------X..X-------X...XXXXX.X..........X-X.X------
--X.........E.X---X....X---XX.......XXXXX.E..A........X-------X..X-----------XH.X-------X..X-----X-X..........X-X-------
---X..........X---X.....X---XXXX....X----X.....E......XXXXXX--X...X-------X-XX..X-----XX....X------X...........X--------
-XXX.:.....E.X----X..E.XXXXX.........XXX-X..................X-XE..X-----XX.X....X----X......X--XX-X.....:......X--------
X...........X-----X.....E...............X.E...H.............X--XXHX----X.....X..X-----XXXXX.XXX..XX.............X---XXX-
X......XXXX..X--XX....A...............EXX........X.......E.H.X-X..X---X........X-----------X..E............XX....X-X...X
X........X-XX--X............E...........X...H.H...............XX...X--X.E..XXXX-------------X...X..........XX.....X....X
X.XXXXH..XX----X..H....X.H..............X...........X........X--X..X---XXXX---XXX-----------X...X.......E..X.......E...X
-X----X....XX---XXXX...............................E.........X--X.X----X.XXXXX...X---------X....X..........:.XX........X
------X......XXX..X-XXH.........E.......X.XXXXXXX.........H..X--X.X----X.E.......X---------X...XX.............X........X
------X......X..E.XXX....................X---XXXXX..........X---X..X---X.........X--------XX..H....E...E.........E.E...X
-------X....X-X..X.....................X.X--X..H.H..H.H...HXX---X..X---X...E...H.X-------XE.....:................X.....X
-------X....X-X..E..H....X.........H..XX..X-X..............X.X--X..X---X.........X-------X........XXXXXX.........X.E..X-
------X......X-XXXXX.X.XXX....E.......X-X.XX....H.............X--X.X---X....A..H.X----XXXE....E.XX---XXX...............X
-------X....AX------X-X--X........E..EX--X-X.........XX.....E.X--XHX---X.A.......X---X............XXX.....X..........:.X
-------X.....X-----------X.X...H......X----X...X....EXX...XXXX---X.X--X..........X---X......X.........XH.AXX..XXXXH....X
-------X.E...X-----------X.X..XXXXXX...X--XX...X......XE.X-------X..X--XX.E..XX.X---X......EX..H.XXXXX-XXX-XE.EX-XX....X
--------XXXXX-------------X-XX-----X...X-X............X..X-------XA.HXXE....X--X---X.H......X.XXX-----------X...X.....X-
-----------------------------------XH.X--X.X..........X.X---------X.......XX-------X...E......X-------------X..........X
---------------------------------XX-XX---X.X.....X....XX----------X......X---------X.....XXXX..X------------X..........X
-----------------------XX-------X..X----X.XX..........XX---------XX.....X----------X...E.X--X..X--XXXXXXXXXX.A.........X
----------------------X..X------X..X--X-X.XX..E.......E.X-------X.....X.X--------XX.......XX....XX.E...E.E......XX.:...X
--X------------------X..H.X-----X..X-X.XX...............X-------X....E...X------X.......XX--X........E..........XX...B.X
-X.XXXXXX------------X....X-----X..XX......E............X-------X.........X-----X...H...X----X....E........E...........X
X........X----------X.....XX---XX..................XXXXX--------X.B.......X-----X......X----X...E..............H.......X
X....XXE..X---XX----X.....H.XXX........XXX.....H.XX-------------X...E......XX---X......AX--X..:.........XXXX.......XXXX-
-XXB.X-X..X--X..X---X.................EX-X......X---------------X.....XXXH.E.XXXX..H....X--X............X---X:.X...X--X-
--X..X-XH.X-X..X----X.A........E....H..X-X..E...X-----------X---X..H..X.................X--X.H..E.......X----XX-X..X-X.X
--X..X-X...XX...XXXX........E..........X-X....XX----------XX.XXXX.....XX....A.H.......XX---X.........X..X-----XXXE..X..X
--X..X-X....X.........XX.E.............X-X....X----------X....................X....E.X-----X..E.....E....XXX-X.........X
---XX---X.XH.X.H.......X....A.........X-X.....X--XX------X............:..............X-----X.............H..X-XXXXXXXXX-
---------X............................X-XE.X..XXX..XXXXXX.XX.E................H......X----X................X------------
----------X.....X.......W..H.....A....X-X.XX.......X......X-X........................X----X.......XXH.X..H.XXXXXXXXXX---
----------X.....X.....X....X.H.......X--X.XXA.XXX.X-XX..X.X-X......E.H.........:.A...X---X......X.....X.......A....A.XX-
---------X.........H.X-X..XX.XXX.....X--X....X--X.X---XXX.X-X.E.........E...........H.XXX.......XX....X.....H..........X
---------X...........X--XX--X--XE....XX-X...X---X.X---X....X....XXXXXXXX..A.....A....XX...E.A...XX.................H...X
---------X.........X.X---------X.......X..XXX---X.X---X.......XX-------X....H.......X--X........:X..EXX................X
----------X...H...X-X----------X.......X.....X--X.X---X....XXX---------X..XXXX..H.E.X--X........X-X.X--XX..............X
----------X....X..X------------X.......X...XX---X.X---X..EX------------X..X---XXXXXX---X......E.X-X..X---XXXXXXE.....XX-
-----------XXX.X...X-----------X.....E.XXXX-----X.X---X..X-------------X..X------------X........X-X.:X---------X....X---
------------X..X...XXXXXXXXXXXX..E....X---------X.X----X.X--------------XX-----------XX...XX....X-X...XX-------X....X---
------------X........H....:..E....X.XX-----------X------X---------------------------X.....X-X....X......X-----X......X--
------------X............XXXX........X-------------------------------------------X-X-XXXXX--X....A......X-----X......X--
-------------XXXX........X---X.A.X..X-------------------------------------------X.X.X-------X:..........X------X......X-
-----------------XXX..H...X--X....EX--------------------------------------------X...X-------X...E...XE..X------X.....X--
--------------------X.....X--X.....X--------------------------------------------X....X------XE......XXXX-------XA.H...X-
--------------------X..E..XXXX....X.X-------------------------------------------X...E.X-----X..B.E..X---------X.......X-
--------------------X:...............X------------------------------------------X.....X-----X......X----------X......X--
-------------------X.................X------------------------------------------X....EX-----X......XX----------X.....X--
-------------------X..........XXXXX..X------------------------XXX-XX-------------X....X-----X........XXX-------X.....XX-
-------------------X.XXX......X---X..X-----------------------X.E.X..X-XXXX------X.....X-X---X.XXXXXXXX..X------X:.:...HX
--------------------X---X.HXXX----X..X-----------------------X...X...X..E.X-----X......XEX---X-------X..XX--X--X.......X
-XXX---------------X.XXX..X-------X.XX-----------------------X...X...X....X-----X........X---X-------X...AXX.X-XH.....X-
X...X--------------X:.....X-------X...X----------------------X......X-X...X-----X........X--X.XXX-----X......X-X....HX--
X..HX--X-----------X......X-------X....X---------------------X.....H.X....X-----X.X......X--X....X----X.......X......X--
X...X-X.X----------X......X-------X.....X--------------------X.......:.....XXX--X.X.H....HXX.....X----XE.............X--
X....X...X--------X..E....X-------X....X---------------XXX----X...............XX-X....H........X.X----X.............EX--
X...E....X--------X.......X--------XXXX--------------XX...X---X........XXXXXE...XXE..........XX..X----X..............X--
-XXXX....X----XXXX......A.X-----------------------XXX...XX----X.........XXX.....XX...........X-XX-----X...:....:......X-
X........X---X.E........XX-----------------------X.....X-----X...E...........:.....:.E.XXXXXX----------X............H.X-
-XXX.....X---X..X.....HX-------------------------XE....X-----X.....XXXX................X---------------X.....XXX..HX...X
----X...X----X.X-X.....X----XXXXXXX------X-------X...XX-------XXX.X----X.....XXXX.E...X---------------X......X-X...X...X
----X..X------X--XE....X---X.....H.XX---X.XXX----XE.X---XXXX-----X---XXX...HX---X...E.XXXXX-----------X.H.....X...H....X
----X...XXXXXXX--X.....X----XXH......X--X....XX-X...X--X....X---XX--X......X----X..........X---------XA.........H....E.X
-XXX..H...A.E..XX.......X---X.X....E.X--X....X.X-X..X-X.E....X-X..X-X.....X------X.........X--------X.....:..X.........X
X.........X..........E..X-XXX:.......X---X......XX..XXX....:.X-X...XH.....X------X.........X-XXX-----XHXXXXXXX.....E...X
XE.......X-X......E......X.H.....X..E.XX--XXXX...X.HX........X-X...........X-----X...X....EXX...X----XX------X.....X...X
X........X--X.......X...................X----X...............X-X...........X------XX.X....X-X....XXXX<X------XH..A.X...X
X........X---X..XX.X-X...X..X....XXXX....X----XXXX.X........:X-XE..........X--------X..H..XX...A......X------X.X...X...X
X...XXXX.X---X..X..XX...........X---X....X--------X-X........X-X............X--------X................X-------X-XXXX...X
X.XX----X----X...EX....XXXXXXX..X---X.H..X---------X....:....X-X....XXXXXX..X---------X.E...X.:..XXXXX----------X...H.X-
X.X----X.X---X....X.XXX------X...X--X....X----------X.......AX-X...X-----X..X---------X..XXX-XXXX---------------X.....X-
-X----X..X---X....XX---------X....XX....X-----------XE....X.XXX....X-----X.X----------X..X----------------------X......X
------X.AXXXX.....X----------X...A...E...XXX--------X............E.X-----X..X---------X..X----------------------X......X
------X............XXX-------X..............XX--XXX-X.....E.......X------X..X---------X..X---------------------X..H....X
-XXXXXX...............XX--XXX...........X.....XX...XX.....X.......X------X.HX---------X.HX---------------------X.....H.X
XA.....E..:....E......E.XX............HX-X...XX....XX.....X......HX------X..X---------X..X----------------------XH.....X
X.......X...X......E......A............X-X...XX....E......X.......X------XEX----------X..X------>----------------X....EX
-X..E..X........XXXXXXXXX.......A.......X...X........E....X.H.....X------X.X----------X..X-----X.XXXX-------------X.H..X
-X.....XA.......X------X...E..............EX-X.....X..............X-------X----------XX.HX-----XH....X-----------X.....X
-X.....X...E...EX------X.............H......X.....................X-----------------X...X------X......XXX--------X.....X
X....E.....XXX..X-----X....:......X.....H.......E...H........H....XX----------------X..X-------X......XH.X-------X..H..X
X........XX--X..X----X......................X.........E.E.....XE....X---------------X..X------X..H.......X-------X.....X
X.....E...XXXX..X---X.....A....E....X..H...................A..XXX...XXXXXXXXXX------X..X------X.....E.E..X-------X.....X
-XX..........X.X---X....E..........AX..........H........XXXXXX---XH....A......X------XX-----XX...........X---XX--XE...AX
---X.........XXXXXX.................X.E...H.E..........X----------X..XX...H....X-----------X.A...........XXXX.HXXX.....X
---X.E...HX..X........XH...E..E...XX.............X....X-----------X:.XX........X-----------X...........................X
--X.......X...XX.....X-X.......XXX--X.........XXXXE...X-----------X..XX.XX.....X-----------XE........A........E....E...X
--X....E..X...XX......X.......X------XXXXX...X---X..W..X-----------X.X-X-X......X----------X...........XXXXX...........X
---XXXXXXX-XXX--XXXXXX-XXXXXXX------------XXX-----XXXXX-------------X-----XXXXXX------------XXXXXXXXXXX-----XXXXXXXXXXX-
