----------------XX-----------------------XXXXXXXX-------XXX----------XX---XXXXX------------------XXXXXXXXX-----XXXXXXXX-
---------------X..X---------------------X.....E..X-----X...X--------X..XXX.....X---------------XX..A.E....X---X...H....X
---------------X..X---------------------X........X-----X...X-------XX..X......H.X-------------X......X....XXXX......A.X-
---------------X..X---------------------X..E..XX.X---XX...A.X-----XH...XX....X..XXXXXXX------XE....................XX..X
---------------X..X------X------------X-X.....X-X---X.......X------X.............E....AXX---X...........E..XXXX...X-X.EX
---XXXXX-------X..X-----X.X-----XXXXXXEXX..X..X----XX..H...X-------X.......E.............XXX..X..................X--X..X
--X..H.AX------X..X-----X.X----X........X..X.X----XE.......X-------X..XXX......XXXXXX...............H..E.........X--X.X-
--XE....X------X..X-----X.X----XE.......H...X------XX...XX.X------X...X-X....EX-----X............................X--X.X-
---X....X------X..X-----X.X-----X........X.X---XXXXXX.HX--X.X-----X...X-X..E.X------X.......A....................X---X--
----X...X------X..X-----X.X-----X.....HXX-X---X.E.......X-X.X-----X....X......X-----X....X........B.......E...W..X------
----X..:X------X..X-----X.X-XX---XXXX..X-----X.....:.H...X..X-----X..:X-XXXXXX------X....X.....X....X............X------
-X---XX..X-----X..X-----X..X..X---XXXH.XXXXXXXX..E.......X..X------XXX--------------X.......X....................X------
X.X---X..X--XXXX..X-----X..X..X--X...........:......:......H.X-------------------XXX.................H.XX...AX...X------
X.X---XE.XXX......X-----X.....X--X...H....X...XXX............X------------------XE....................X-X....X....XXXX--
X..X--X..X.......X------XH.....XXX........X..EX--XH.......H.EX------------------X.XXX..............XXX--X...........E.X-
X...X-X.H.E..XX..X------X...XXX.E......E..X....X--XXXXXXXXXXX--------------------X..H..H........:.X-----X.:XXXXX.XXXXX--
X.X..XXX.....X...X-XXXXXE..X---X.XX.......X.HXX----------------------------------XH................X----XXX-----X-------
-X-X.....H...X.:.XX..H....EX---X.............X-----------------------------------X...X...E.....E....X-XX.XXXXX----------
----X.......:X...XX...X.....X--X..E..........X-----------------------------------X..X-XXXXXX.........X........X---------
----X........X..X........X...XX..........XX..X-----------------------------------X...X------X.X.........E.....X---------
-----XX..........E...XXXXX.......W.....A.XX..X-----------------------------X--XXX....X------X........H....XXH.X---------
------X.........XXXXX-XXX-X........B...XXX...X------------------------X---X.XX..X.....X-----X.X..........X--X.X---------
------X........X-----X...XX...........X---XXX------------------------X.XXX...X..XX.....X-----XX.....E..X..XXX.X---------
------X.......EX------X........:.......XXXX-------------------------X...A..E....XE.....X-----X........X-X.....AXXXXXXXX-
-------XXXX..XX-------XH............E......X------------------------X........E.....E...X----X..EXXXX..X-X.............HX
-----------XX----------X...A.............E.X-X----------------------X...............XE..X----X..X-X...X-X....XX........X
-----------------XXX--X.....XX......XX.....XX.X------------XX-------X.H..E....XXX...X...X----X...X.....XX...X--XHXE..XX-
-----------XXX--XA..X-X....................XX.X-X---------X..X-------XXXXX...X--X......EX-----X..XX..H.E....X---X-X..XX-
----------XH..X-X..E.XX...XXX.............E...XX.X--------X..X------------X...XX........X-----X.X--X.........X----X....X
----------X....X.H..X--X...X-X.........H......XX.X--------X.HX------------X..........H.AX-----X..X-X.....H...X----X....X
---XX-----X.........X--X....XX..X.........HX..XX.XXXXX----X..X------------X......XXXXXX..X-X--X..X-XH........X--X-X....X
-XX..X----X.........X--X.XXXX..X-X..E.A.......XX.E.E..X--X...X-----------XX....EX-----X..XX.XXX..X-X......H.X--X.X....X-
X....X----X.......XX----XXXX.E.XX........E............X--X:.X-----------X.E....X------X...X......X-X.....XXX---X.......X
X....X----X.........XXXXX.E....XX...............H...EX--X...X-----------X...XXX--------X.XX.H...X--X..XXX------X.E.XX..X
-X.E.X----X.XXH................XX.........E.........X-XX..HX-------------XXX------------X-X.....X-X..EX---------XXX-X..X
X....X-----X-X.................XX..............X.....X...XX-------------------------------X.XXXX---XXX--------------X..X
X....X--------XXX.....H...........X............X.........X---------------------------------X------------------------X.EX
X.....XXXX---X.XX.E...XX...XXX....X........H...X.........X----------------------------------------------------------X..X
X...X....HX--X.........E....XX.......A.............A.X..HX------------------XXX-------------------------------------X..X
X.XX-X....X--X...X......XXX....XXX...............XXX.....X-----------------X...X---------------------X--------------X..X
-X----XX..XX--X.X-X....X---XH.X--X...........:.XX---X....X----------------X...X---------X-----------X.XXXXXXXX-----X...X
--------X.E.X--X--X.E..X---X..X--XXX.E.X......X-XXXXXX...X----------------X..X---------X.X----------X.........X-----X..X
--------X...X---X-X...X----X..XXX.X-X..XH......X..E......X----------------X..X---------X..X---------X..........X-----X.X
---------X..X--X.XX...X----X......X-X..XX..A.XX-XX..H....X-------XX-------X..X------XXX..XX---------X..XX.......XXXXXX.X
---------X.X---X.....X------XXXXXX--X...X....X-XX........X------X..X------X..X-----X.......X--------X..X-XXXX..........X
---------X.XXXXX.....X--------------X.A.......XA.........X-----X..BX------X..X-----X...XX..X--------X..X-XXX.E.........X
------XXX...........X---------------X....:........H.....X------X...X------X..XX---XH...XX..X---------X..X......EXXX.H.XX
-----X........H....E.XX-------------X..........H........X------X...X------X....X---XXXX-X...X--------X..........X--X....
-----X......:.XXX....E.X-----------X..............XXX.XX------X.....XXXXXXX....X--------XH.EXXXXXXXXX..XX...XXXX---X...X
-----X....XX.X---X...XX-----------X............XXX---X--------X:...............X---------X............X--X..X-------X..X
------X...X-X-----X.X-----XX--X----XH..........X--------------X.................XXXX----X..H......XXXX----XX--------X..X
-------X..X-----XX..X----X..XX.X--X..XXXX...H...X-------------X........XX.H...:.....X---X...XXXXXX-------------------X.X
-------X.X-----X....X---X-X.E..X--X.X----XXX.....X------XXX---XE......X--X...........XXX...HX------------------XX-----X-
-X-----X.X----X...X:.XXX.X-X...X---X-------X.....X-----X...X--X.....H.X--XA....E............X-----------------XH.X------
XEX----X.X---X.....X......X.....XXX.X------X.X...X-----XX..X--X.......X---XXXX........XXXXXX-----------------XX..X------
X.X---X..X--X..XXXXXH.....X..E..A...X-------X-X...XXXXX...X---X......X-----XXXX.H...:.X------X--------------X.E..X------
X.X---X..X--X.EX----XXX...XXXXXX....X---------X...........X---X.....X-----X..........X------X.X------------XB....X------
X..X--X...XXX..X------X..AX-----X...X----XXXXX...H......HX----X.....XX----X..........X---XXX...X-----------X.....X------
-X..X-X.....XXX-------X...X-----X.E.X---X..........H..X..X----XH......X--XH..........X--X......X---XX-------X....X------
-XE.XXX.....X---------X...X----XH...X---X....XX.......XE.X----X.......X-X..........E.X---X...X.XXXX..X------X....X------
--X..........X---------XXX------X.H.X---X....XX.....E....X----X......X--X...........X-----X.X-X......X------X.HXX-------
--X...E..X....X-----------------XX..X---X.E.XX...........X----X.....X--XE...:........X----X.XX........X-----X..X--------
--X.XXX..XXXXX----------------XX....EXX-X...............HX----X.....X--X...XXX...X....X---XEXX......H.X-----X.EX--------
---X--XE.X------XXXX---------X..A......XXA..H...X...XXX..X----X......XX.X.X---XXX-X...X---X.X-X...E...X-----X.X---------
------X..X---XXX...<X---------X..X.....XX..........E.XX...XXXX.......A...X--------X..EX---X.XX.........X----X..X------X-
------X...X-X.....XX----------X.X-X.X..X-X.....X......H.......E.........X-----XXXXXXX.X---X.............X---X..X-----X.X
------X...X-X.....X------------X--X.XXX---XXA....................:......X----X........X--X.H...XX.......X---X...XX---X.X
--XXXXX...X-X...H..X------------XXXAX-------X............XX.E..E........X--X--XX......X-X......X-X....XX----X.....XXX..X
-X.........XX.....HX-----------X....X-----XXH..X........X--X....XXXXXXXX--X.X---XX....X-X......XXX...X------X..........X
-X.E..............X-------------X...X-XX-X....X-XXXXXXXX---X...X----------X..X----X..X---X..H.X......X------X..........X
--X.......H.......X---------X---X...XX..X:.....X----------X....X-----------XH.XX--X.X---X............XX-----X....H.....X
--X.....X..........XX-----XX.X--X.X.E..E.......X-----------XXX..X-----------X.X.XX..X---X......E...A...X----X.........X-
--XA....X............X---X....X--X-X...........X-------------X..X----------X.......HX---X....XXXXXXX....X---X......:..X-
--X.....E.......E....X---X..A.X-X.XX.....E.H...X--XXX--XX----X..XX----------X.......X----X...X------X.H.X--X...........X
--X.H........XX...XXX----X....EX.....H...XX...X--X...XX..X---X....X----------X......X-----XXEXXXX---XX..X--XE.......X..X
-X..XXXXXXX.....AX------X...............XX..X..XXX.......X----XXX.X-----------X....X-------X.....X-X.....X-X...XXX..E..X
--XX-------XXXX..X------X..........X.....X..XXXX..E..E....X------XX-----------X...X--------X:....X-X..X...X-XXX--X..X..X
---------------XX-------X....E....X-XXXXX-XX---XXX.........X-----X.X----------X.X.X---------XXX..X--XX-X.X-------X.X-X.X
------X-----------------X.........X-----------X...E.......H.XXXXX..X-----------XXEX-----------X.E.X-----X--------X..X..X
-XX--X.X-----------------XXXXXX...X------------X...................X------------X.X-----------X..XX--------------X.....X
X..X-X.XXXXXX------------------XXX--------------XXX.HXX...........HX-----------X..X------------X.X.X--------XX-XXX.....X
X..X-X.XH....X------------------------------XX----X..X-X...........X-----------X.HX-----XXXXX--X...XXXXXXXXX..X..E.....X
X..XXX.XX.....XXX-XX>-------------------XXXX..XXX-X..X-X.E........HX-----------X..X---XX...E.X-X.X...........E.X......EX
X..X.X.XX...XXX..X...X-------------XXX-X.........X....X-XXXXXXXXXXX------------X..X--X.......X-X..........X............X
X..X.X.XX..X---X...E.X-----------XX...X-X...X.E.......X--------------------XXXXX...XX.........X.....................H..X
X..........X--X......X----------X....XX-X............E.XXXXX--------------X..................AXXX......E.H..H..........X
XE...E......XX.......X----------X......XX...E...........A...X-------------X...H..............X--X......................X
X............X...XXXX-----------X....E.X.........XXXX.......X-------------X.......E..........XXX-XXA..........E.......X-
X............X..X---------------X......X........X---XH......X-------------X:.................E.HXX.....................X
-XX.XXX......X..X-------------XXE...H.:.XXXXXX..X----XX......XXXX---------X....XXE...X.H.......X-X.........XX..........X
--X..XE.E......X--------XX---X.........X--XA.....X-----XX........X--------X....X-XX..XX........X-X...:...E.X-XXXE...H..X
-X...X.....XXXX--------X..XXX..........XXX.....E.X------X.......AX---XXXXX....X----X.HXXXXX.E..X-X........X-----X..XXXX-
--X........X-----------X.XX.......E.....H.........X-----X.......X---X..E....H.X----X..X----X....X....E...X--X----XX-----
--X........X-----------X.H..........H..XXX..XXX....X---X.......X----X.........X-----XX-----X.....EXXXXX..X-X.XXXX.XXX---
--X...E.XXX-XXXXX-X----X....E..........X--XX---XX...X--X.......X----X.:.......X-------XXXXX..H....X--XXX..X..........X--
---XX..X-XXXE...:X.X---X.....XX........XXXX-----X...X---X.....:XXXXX.........X-------X...E......HX--X.....X..A......EX--
---X...XX..........X---X......X.....H......X-----X..X----X.E.......X......E...X------X.........XX---X..:..X....X..H..XX-
---X...XX.........EX---X......XXX..XXXXX..X-------X.X----X.........X.A.H.X....X------X......H....X--X.....X.........:..X
---X......A.......X----X..XXXX--X..X----XX---------XXX----X.H............X.....X---XXXXXXXXXX....X-XXHX.....:..........X
-XX.........:.X...XXXX--X.X-----X..X--------------X...XX--X..XXH......H..E..E...XXX...XX-----X...XX...XX..............AX
X............X........XX..X-----X..X--------------X...E.X-X..XX.................A......HX----X...XX.HX-X...XXXXX.......X
X..H..XX...........:......X------XX---------------X....X---X.......XXE...XX....XXXXXXXXX----X....XX.X-X....X---X.......X
X....X-X........XXXXXXXXXX------------------------X...HX--X........XX...X--XX.X-------------X.......X-X....X--X.X......X
X..XX.X.....H..X----------------XXXXXXX-----------X....X-XH.............X----X--------------X........XX....XXXB........X
X..............X---------------X.......X----------X.....X.....XXXXX.....X--------------------XXX.X.....H...............X
X.XX.....E.....X---------------X.......X-----------X..A...X...XXX--X....X----------------------XX-X...............X:...X
X.X-X..........X----------------XXX....X----------X........:.....X--X...X---------------------X..X...............X-X.E.X
X.XXX.X.....X...X-----------------X....X----------X..............X--X...X---------------------X.........E........XX....X
X.....XXXXXX...X------------------XX..EX---------X..XX........H..X--X..EX----------------------X.....XXX......A..X...XX-
X..XXX------X.X------------------XH...X----------X.:.............X---X..XX---------------------X.....X--XX.......E..X---
X.X-----XXXXX.X-------XXXXXX---XXX...X------------XX............X---X.....X------XXX-----------X.H...X---X.....XXX.X----
XEX----X......X------X:.....X-X....X..X-------------X..........X----X..A..X-----X...X---------X...XXX-----X...X---X-X-X-
-X-----XXX..H.XX-----X......X--X.HXX.HX--------XXXXX.:......XXX----X..XX.HX-----XH..AX---------X.....XXXXX....X----X.X.X
------X..X......X---XE.......XX..X-X..XXX-----X..........X.X--------XX-X..X----X....X-----------X.............X----X...X
-----X......E....X--X........XX.X--X.....X----X..E......X-X------------X..X----X....X------------XXXXXXXH....X-----X...X
----X..E....XXX.X---X.........X.X--X.....X----X.........X--------------X:.X-XXXX..XX.X-----------------X..E.X------X...X
-----XXXX...X-X.X----XX..........X-X.....X-----X...E....X--------------X..XX...X...XH.XXXXX-----------X......XXXXXX....X
--------X....X...X-----XXXX......X-X......XXXXXX.......X---------------X..X...E.......E....X--------XX..........H......X
--------X........X---------X.A..HX-X...H...............X---------------X............E...E..X-------X.....XX........HX..X
---------XXXXXXXX-----------XXXXX---XXXXXXXXE..XXXXXXXX-----------------XXXXXXXXXXXXXXXXXXX---------XXXXX--XXXXXXXXX-XX-
