-XXXXX-XXX----------------XXXXXX----------------------X--XXX------------XXXXXXXX---------------XXXXX--------------------
X..:..X...XX-------------X.E..B.X--------------------X.XX...X----------X........XX-XX---------X.....X-------------------
X.....XX...EX-------------X......X-------------------XH....X-----------X..........X..X--------XX..XX--------------------
X........XX.<X------------X.....A.X------------------X.....X-----------X.............X-------XH..X----------------------
X...E...X--XX-------------X........X--------------X---XX..AX-----------X.........H..H.XX-----X..EX----------------------
X......X------------------X....E...X-------------X.X---X.X.X------------X...H..........HX----X..X-----------------------
X.H....X-----------------X.........X-----------XX.:.XXX-XX.XXXXXX--------XX.........X...X----X..X-----------------------
X.....X------------------X.......X.X----------XA.......XX..X.E...X---------XE...A...XX..X----X..X-----------------------
X....X--------------------X.....X-X-----------X..XXXXX....X-X....X---------X........X..X-----X..X-----------------------
X...EX---------------------X.....XXX----------X.X-----X...X-X.....X--------X......HXX.X------X..X-----------------------
X....XXX--------------------X.......X----------X------X.:..XXH..E.X-------X............XXXXXXX..X-----------------------
X......HX-------------------X........X---------------X..XX..X....X-----XXX.....:....X..B........XXXXX-------------------
X.......X------------------XX..A.....X--X------------X.X--X......X----X......A........XXXX..E..E....HX---------------->-
-XXXXX..X-----------X-----X....X.....X-X.XX-------XXXX.X--X....XX-X---X..............X----XXXX.......X---------------X.X
-----X..X----------X.X-XXX...EX-XX....XE...X-----X......X-X......X.XXX...E....H....H.X--------XXXXX..X---------------X.X
-----X..XXXXX------X..X.......X---X.......X------X.E..X..XE.....................XX...X------------X...X-----------XXX..X
-----X.H.....XXXXXXX.......X..X---X........X------XXXX-XX......X..E...............XXX-------------X..X---------X-X.....X
-----X.X...........E.E........X---X....XX..X-------------XE....X................E.X---------------X..X--------X.XX.....X
-XXXXE.XXXX.X..........XXXXXXX.XXX...A.XX..X-------------X...XXX.....:.....A..X...X---------------X..X--------X......X.X
X.......X-X.X.XXXXXXXXX------X.E......X-X..XX------------X.E................X.....X---------------XE.X--------X.H..E.X.X
X...HXXX--X.....X-------------X...A...X-XH...X--------X--X....E..........XXXX.....X----------------XX----XXXXXX........X
X....X---X.A.....X-------------X:.XX.HX-X...X------XXX.XX...XXXXXXXX....X--X......X---------------------X........A.....X
X....X---X......E.X-------------XXX...X-XE...X----X........X--------X...X--X.....XX-XXXX-----------------X....XXXXX....X
X....X--XE....E...XXX----------X--X..HX--XXXX----X....E....X---------XX.X--X.......X.E..X----------------X..XX---X.H...X
-XX..X---X...........X--------X.XX...X------------XXXXXXX...X----------X----XX.EX.......X----------------X...XXXX......X
X.E.HX---X............X-------XE.....X-------------------XXX------------XXX---XX-XX..E...X---------------X..X..E..X....X
-XXXX----X..XXXXXXXX..X-------X.......X----------------------XXXXXXX---X...X-----X.......X---------------X.X-X...X-X...X
---------X..EX-XXXXX..X-------X.....E..XX------------------XX....H..XXXX...X-----X..E.X..X---------------X.XX....X-X...X
--------XE....X.E..X.X--------X.E........X----------------X......X.XX...A..XXXXX-X......X--------------XX.A..H...X-X...X
---------XXX..E....XX---------X...XXXX...X----------------X..:XEX-XX.E..........X......X--------------X...........X..H.X
------------XXXXXX...X--------X..X----X..XXX---------------XXXX.X---X........H......:...X--------------X.XX.X..........X
-----------------X...X--------X...X---XH....X-----------XXX---X..XX-X.....XXXXX..........XX------------XHXX......E.....X
------------------XXX---------X:..X---X.....X----------X...X--X....X....AX----X...XXXXXXXX.X-----------X...XX.........:X
------------------------------X..HX----XXXXX-----------X..:X---X...XX...X-----X..X-------X.X-----------X..X--X..:......X
------------------------------X...X---------------------X..X-XX..H...X.X-------XX--------X.X-----------X..X--X.....:.XX-
------------------------------X.X..X---XXX--------------X...X...........X----------------X.X----------X....X-X....XX..X-
--------------XXX--------------X-X.XXXX...XX-------------XX......XA..XX..X--------------X..XXXX-------X....X--XE..X-XX--
---XXXXXXXX--X...X---------------X...H.H...EX-------------X...X.X-X.X--XX---------------X.E....XXX----XX:..X--X..X------
--X........XX....X----------------X..........XXXXXXXXXXXX-X..X-X.XH..X-----------------X.........HXXXX.XXXX---XH.X------
-XX............A.X-X---------------XXX...XXXX.E..........XE..X-X.....X-----------------XE.............HX------X..XXX----
X.......H........XX.X-XXXXX----------X...X---X......E.......EX--XXXXX------------------X.......X....XXX-------X..X.EX---
X..X................XX.....XXX------X....XXXXXX...E..........X-------------------------X..E.XH.X.......XXXX---X....X----
-XXX......E..........X.....X..X----X............X............X---X---------------------X.......X...........X-XX.A.X-----
---X.................X...H.X..X----X................A....XXXX.XXX.XXXX----------------XX.......X............X.....X-----
-X-X.......................X..X-XXX....E...X.H...........X--X.........XX-------------X.....X.....H.....XX........X------
X.XX...............XX.........XX..X.......XX....H........X--X.HXX...E...XX-XX--------X...XX-X.HXX......XX........X------
X.......H.E.......X--X........XX.......X..XX...........H..XX-XXX........:.X..X--------XXX----XX-X......XX........X-XXXX-
X..............XXX----X...X...XX......X-X.XX..B..........:.EX--X.............X-------------------XXXXXX-X..E.....XX.E..X
X...E...H....XX-------X.....XE.X.H....X--XX-X......E....XXXX---X........X.....XXXX----------------------X........X-X...X
XE......XXX.X---------X....E..X....E..X--X.X...........X------X..X.....X-XH.......X--------------XX---XX........HXXXH..X
-X......X--X----------X.......X..X....X-X.........H....X------X..E.X...X--XXXX.H...XXXX---X-----X..X-X.....XX.....HX...X
X.......X-------------X.........X-X....X.....A.......E.X------X...X-XXX-------X...X....X-X.X-XXX.H.XX..H..X-X..X.......X
X..X...:X-------------X.........HX.....X...A.....H.....X------XE.X-----------X.......EX--X..X..X.....E....X-X.X-X...XXX-
X.XX....X--------------X..............X-XXXXXX.........X------XXX------------X.EXX.....XX......XX.A......EX-X.X--X.X----
X.......X---------------X....B........X-------XX.......X-----X...XXXXXX------X...X.A.........XX.........X.X-X.X--X.X----
-X.H....X---------------X......XXXX.XX-----XXX.......XX-------X........X-----X...............X-X..E.....X.X-X.X---X-----
-X.......XXXXXXX--------XH..X...X--X------X.E........X--------X......H..XX--X..X.........X...X-XH...H...XX--X.X---------
--XX............X----XXXX..EXX.X---XX-----X........EX--------X............XX...X.H.E...XXX...X-X........X--X...X--------
-X.:............X-XXX.......XA..XXX..XX---X.X..:...X---------X..XX...XX.E.............X---XX.X--X.E.....X--X.X..X-------
-X...E...E......XX...............:.....XXX.........X---------XE.X.X.X--X...E.......XXX------X---X......X---X.X..X-------
X.................XX.A..................E.:....H...X---------X....X..XX...........X-------------X.......XXX......X------
X.....XXXXXXXXXX..X-X...........H...........XXX..XX.XXX------X.......X.XX........X-------------X..................X-----
X.....X--------X..X-X.........E........A...X---X..E....X----X..........XX..X......X-------------XXX..XX...........X-XXX-
X.XXXX---------X.X---X..XXXX...............X--X.........XXXX..E..H......X.XX...A..X----------------XX--XXXX.......XX...X
-X----------XXXXX----XHX----X............H.X-X...XXXX...............X..H...H.XX..HX---X-------------------X..E........X-
------XX---X....X-----X-----X..XXXXXXX....X--X...XXXX..XX......E..XX-X....XX.XX...X--X.XX-----------------X..........X--
-----X..XXX.....X----XX-----X.X------X....X--X........HXX.........X--X...X--X.....X--X...X----------------XXXXXXX..XX---
-----X..........X---X..X----X.XXXX---X....X--X.........X-X..:......XX.H...XX......X---X.:XX--------------X...XXX-X..X---
------X.H......EX---X.AX----X.H...X--X....X---X.......X--X........X-X....XX...X..X----X....X-------------X......X-X.XXX-
------X..........XXXX..X----X......X-X....X--XE........XX...XX...X--X...........X-----X.....X-------------XX..XX--XH...X
------X................X----X.X.H.:X-X....X--X.......XXX-XXX--XXX---X...........X-----X...XAX------------X...XX-X-X..X.X
----XX...............HX-----X.XXX..X-X....X--X.H..H..XH.X----------X..H......XX.X-----X...XX------------X......X:X...E.X
-XXX.......E....H......XXXX--X--X..X-X..H..X-X.......X...XX--------X........X-X.X---XXX...XX------------X.XX..E........X
X...H..XXX...........X.....X----X...X......X-X...........X.X------X........X-X..X--X..X.....XXXXXXXXXXXX.....X....E....X
X...XXX--X....XXXXXXX-X.....X--XXX..........XE.............X------X.........XX..X--X..XXXXE.................X-X.X......X
X...X----X...X--------X..E...XX....:...XX.H....:.....E.....XXX---X..............X--X..X--X......XXX........X-X.....XX..X
-X..X-----XXHX--------X.....H........H.X-X.......X............X--X..H.........:.X--X.X----XXXXX.X-X:.......X-X....X--X.X
-X..X-------X----------XXXXXXXXXX......XX........X............X---X....H.......X--X...X--------X---X.......X--XXX..X--X-
-X..X-----------------XX---------XXXXXXX.:..E....XXX...H......X---XH.....E...H..XXXE..X-------------X.......X----X.X----
-X..X----------------X..X---------------X.....E...........AXXX----X....................X------------X........X---X.X----
-X.X-----------------X..XXXXXXX---------X..H.....X........X------XXE........XX..E......X------------X.........X---X-----
X.E.X-------------XXX...X......XXXX-----X.......X-XX......X-XX--X...........XX......X...X-----------X.........X---------
X....XX----------X.............X...X----X.....E.X--X.......X.AXXX..XX.............XX-XXX-------------X.......X--------X-
X......X----------XXXXXX..........:X----XA......X--X.............XX--XX...E.H....X------------X------X.....XX--------X.X
X......X---------------X...X...H...X----X........XX.......E......X--XXX..........X--------XXXX.XXXXXXX.X..EX---------X.X
-XXXXXX---------------XE..EXX.......XXXX.....H..........H........X-X..............XXX----X...........XX-X...X--XXXXXX..X
-XXX--XXXXXXXX--------X....X-X.......................XXXXXXX.....X--X................X---X...XXE......X-X...X-X......H.X
X...XX........X--------XX..XX...A.E............X.....X-----X...XX----XE..........X..A.X---XXX-X.......XX....X-X........X
X...H.........X--------XX.XX....XX.........E.A........X----X.X..X----X..XX...H..X.....X-------X.............X-X..:....HX
X.....XX......X------XX..X--X...X-X....................X---X.X.X-----X..XX.........E..X-------XE........E...XX.....EXXX-
XH...X-XH.....X-----X.H..X--XE.X---XXXX......XXA.A......X---X...X----X...X....XXX......X-------X.:.........H......XX----
X....X-X......X-----X....X--X..X------XX....X--XXXXA....X--XE.XX-----X.......X--XE.....X-------X.........E.......X------
X...EX-X.....EX-----X.....XX...X--X--X......X------X.....XX...XXX----X..A.....X--XXXXXX--------X................XXX-----
X....X-XH..A..X------XX.........XX.X-X......X------X.....E..A....X---X.........XXXX-------------X..................X----
X.XXXXXX......X--------XXXX........X-X...H..X------X:.A..........X---X...X.........X--------X----X.XX.E.......H..:..X---
XEX-X.E......X-------------X..E....XX...XX..X-------X......W....X----X..X-X...E....X-------XHX----X-X.XXX..........X----
X.X--X..:...X--------------X.........HXX--XX--------X...........X----X..X-X........X---XXXXX.X-------X---XE.......X-----
X.X---X......X---XXXX------X.XX.......X-XXX----------XXXX.......X----X..X-X.........XXX......X------------X........X----
X..X--X.....X---X....X------X-X...H...XX...X------------X...XXXX-----X...X...................X--------XXXXXA.......X----
X...XX...E.X-----X...X---------X....XX-XE..XX-X---XXX---X...X---X----X.....E........H.......HXX-XXXXXX.....XXXX....X----
X.XX--X.....X---X....X---------XE.XX----X.XX.X.X-X...X--X..H.XXX.X---X..E....................X.X.....H....X---X..H.X----
-X----X......XXXX....X---------X.X------X.XX....X...X---X..XXX...X----X....................E.E...H......W..X--X....X----
------X....E.X..E..H.X---------X.X------X.XX........XXXXX..X-X...X----X..E.E.E......XX.................XXX.X--X.....XXX-
------X..............X---------X.X------X..XX..A..HXX......X-X...X----X.........A....XXX..............H.XX..XXX........X
------X.:............X---XXXXXX..X-XX---X..XX......XX.H....X--X..XX----XXXXXXXXX.....X......H......E..XX-X..H.......E..X
-XXXXX...XXXXXXXXXXX..XXX.........X..XX-X..X-X..A..E.XXX...X-X....EX------------X.X...XX..XX.........X----X...X........X
X.........:.X-XX.XXX.......XE........X.X....XX.......X-X....X......X-------------X-XXX-X........E....X----X.EX-X.......X
X...........XX....H....E..X-X.......HX.....XX.......EXX....H..A....X------------X.XXXXX......A.......X----X.X--X...XXXX-
X.......HXXXX..E..........X-XH...........E.X.H...XXXX.............H.X-----------X......E...........E.X-XXX..X--X....X-X-
X.....:..X--X......A.XX.XX--X........X..........X----X....E.........X-----------X........E...........XX......X-X.....X.X
X...E....X--X.............X-X.......E.......E...X-----X..............X----------X...XX.........X..B...........XX.......X
X.....X.:.XX-XXXX.........XX.....H.......E......HXX---X..............X----------X...X-X..H...................HXX..XX.H.X
XE..........X---X.......XX.....E..X:..H......E....HX--X..XE..E...A...EX---X-----X....XX.............E........X--XXX....X
X...........X----X..H...XXX......X-X.X..XE.X.......X---XX-X............X-X.XXXXX...........X..H.......H......X-X.....:.X
-XX.....E...X-----XXXXX...XX..E...XXX-X.XX.........X------X..E.........X-XH.....X.........XX.............E..X--X..A....X
---X........XXXXX------X.X-XH........X-X.X........AX-----X..............XX.....X-X...XX...XXA..............X---X.......X
----X............XXXXXXX.X--XXXX..XXX--X..E.......X-------X....X........XX..H...X....X-XXX-X..E.E.......H...XXX........X
----X...........X.........X----X.....X-X:..........X--XXXX.H....X.......XX............X-----XXXXX.....................X-
---XE.......XXXX-XX.......X----X...E..X...H.........XX..........XH......XX..H........X-----------X.H.....XXXXXX.......X-
----XXXXXXXX-------XXXXXXX------XXXXXX-XXXXXXXXXXXXX--XXXXXXXXXX-XXXXXXX--XXXXXXXXXXX-------------XXXXXXX------XXXXXXX--
