--------------------------------------X-
-------------------------------------X<X
-------------------------------------XHX
----------------------------------XXX..X
---------------------------------X.....X
---------------------------------X.....X
---------------------------------X...H.X
---------------------------------XH....X
--------------------------------X...:..X
------------------------------XX..H....X
-----------------------------X........WX
-----------------------------X.........X
------------------------------XXX....E.X
------------------------------XXX.B....X
-----------------------------X......H..X
----------------------------XX...XX....X
---------------------------X.....X.H...X
---------------------------X.........B.X
---------------------------X...........X
----------------------------XX....XX...X
------------------------------X.XX.B...X
-------------------------------X-X...E.X
----------------------------------X....X
------------>X-------------X--XX--X....X
-----------X..X-----------X.XXE.X-X....X
----------X...X----------X......X-X..E.X
----------X...X-----------XXXXX..X....HX
----------X...XXX-------------X.......:X
----------X......X------------X........X
-----------XXH...X-------------X.......X
-------------XX.EX-------------X......AX
--------------X..X--------------X......X
--------------X..X---------------X..X..X
--------------X..X----XXXXXXXXXXXX..X..X
--------------X..X---XE.....E......X-XX-
--------------X..XXXX.W......B....BX----
--------------X...E....XXXXXXXXXXXX-----
--------------X.........X---------------
---------------X.A......X---------------
----------------XXXXXXXX----------------
