---------XXXXXXXXXXXXXXXXXXXXXXXXXXXXXXXXXXXXXXXXXXXXXXXXX---------------XX---------XXXXXXXXXXXXXXXXXXXX-------XX-XXXXX-
--------X...........................H.........H........E..X-------------X..XXXXXX--X...........H........X-----X.:X..E.<X
--------X...:X.........XX.........A....................X.X-------------X.........XX.H.XXXXX.A....X......X-----X.....XXX-
-------X.XXXX.......E.E...............XXXXXXXXXXXXX...E.X--------------X..E......E..XX-----XXXXXX-XXXXXX-------XX..X----
-------XEX---X.........XX............HX-----------XE.....X--------------X.XXXXXXXXXX----------------------------X...X---
-------X.XX--X.E..A....X-X..H..........XXXX-------X......X-------------X..X-----------------------------------XX..HX----
------X....X-X.........X--X.XX.....XX......X------X......X--------------X.X----------------------------------X....X-----
-----X..E...XX.........X---X--XXX.X--X.....X-------XXXXX>-------------XXX.X-----X----------------------------X.XXXXXXXX-
----XX.................X--------X..X-XX....X-------------------------X.....XXXXX.X--------------------------X..X.X.....X
-XXX...X.......:....XXX---XX---X..XXX....X.X-------------------------X....H.......X-------------------------X......:...X
X..X...XX.........XX-----X..X--X....XXXXX-X----------------------XXXX.............X--------------XXXX-------X..A.....H.X
X.A...X-X......E.X--------XAX---X...X---X-----------------------X.E....X.....E....X-------------X....X--XXXXE......A...X
X....X--X...A....X--XXXXX-X.X----XXX---X.XX-------------XXX-----X....XX-X.........X------------XX..XX--X.......H.....E.X
X...EX--X.........XX.....XX.X----------X...X---------XXX.E.X----X...X----X........X-----------X...X-----X.XX...........X
X.XXX---X...A.......:.H..XX.X----------X..X---------X......X----X....X---X....E...X----------X..HX------X..............X
-X------X...........X.......X----------X...X--------X.....X-----X.....XXX.........X---------X.X..X------X.....A........X
-------XX...........X.AXX...X-XXXXXXXXX..E.X---------XXXX..X----X...........E....X----------X.X..X-------X..XXX.H......X
------X...............X--X...X...W...AX....X---------XXX..X-----X...XH...........X----------X.E...XX------XX---X.....E.X
------X..............EX---XH.X.A..X.......HX--------X.....X------XXX.......H......XXX------X......E.X---------X...H....X
-------X............XX----X..X....X........X--------X....EX------X.XX....H...........X----X.........X------XX-X........X
-------X.............X---XE..........H.....X------XX.....X-----XX...X...........E...X------X...XXX..X-----X..X.H......X-
--------XXX....XX....X---X....E..XXE......X------X.......X----X.....X.....:........X-------X.XX---X..X----X..XXX.....EX-
----------X....X-X...EX--XE......XX......X-------X.......X----X....XX.....XX.E.X...X-------XX----XH..X----X..XXX......X-
-----XXXXX..X...XX.....XX..XXXX.H........X-------X.......X----X..........X--XXX-X..X------X..X---X...X-XXX.....E.......X
----X...........XX.......XXXX-X..........X--------X.:....XX----X........X--------XX------XX.X---X.X..XX..A..X..........X
----X.........W.XX.....:.....X...H.......X--------X....X..EX----X..A...X----------------X...XXXX..X.......X.X...A......X
----X....E...XXX--X.....XX....XX...E......XXXXX---X.:.XX...X----X.....X---------------XXX..XX.....E...H..X-X...XX......X
-----XXXX...X--XXX....XX--XX.X--XXXXXX.........X---X..X-XXX-----X.....X--------------X....X--X..........X--X...X-XX....X
---------X...XXE.....X-----XEX------XXX.E..H..HX--X....XX-------X..XXX---------------X.A.X----XXX.......X--X...X-X.....X
---------X..E....X....X----X.X-----X:..........X--X......X-----X..A..XX----X----------X..X---XXX..XXX...X--X...X-X.....X
---------X...........X-----X.X------X.E.....E..X---XX....X----X........X--X.X---XXXX--XH.X--X....X---X..X--X...XX......X
---------X.E.....H..X----XX..X------X..........X-----XX..X----X...XXXXX---X.X--X....XX...X--X....X---X..X--X....XE.....X
---------X..XXXXXXXX----X.....X-----X.H......E.X------X..XXXX-X.H.XXXX----X.X--X....X-X...X--X...X---X...X-X..X.X......X
---------X.X-----------XX.X...X-----X...E..XXXX-------X....:.XX......AX---X.HX-X....X-XE..X--X...X----XXX-XX.X-X.......X
---------X..X----XXXXXX.......X-----X.E...X-----------X......XX.......X---X...X..:..X-X...X--X...X-------X.H.XX..XXXX.X-
---------X..X---X.............X-----X.....X----------X.......XX....X..X---X.......X.X-X...XXX..X.X-------X....X..X---X--
-XXXXXXXXX.X-----XXXXXXX.....HX-----X...E.X-----------XX.........HX-XX----X.XXXXXX-X--X........H.X-------X...X-XX-----X-
X...:......X------------X.....X------X....X------------X.........X--------X.X---------X..........X-------X..X--------X.X
X.........AX---XX-------XE.E..X------X....X-------------XXXX.XXXX--XXXXX-X..XXXXXXXX--X.....E....X------X..X------XXXH.X
-XXXXXXXXXX---X..XXXXXXX......X-------XX..X---------------XX.X----X.....X...........X-X........E.X-------XX.XX--XX.....X
-------------X...............X---------X..X-------------XX...X---X.............E....X-X..........X--------X..HXXE...E..X
--------------XXX......X.....XX---------X.X------------X.....X----X.................X-X..........X--------X............X
--------------X.......XX.......X---------X---------XXXX......X-----XXXXXXXX.E........XX.A...XXXXX---------X............X
----------XXXXX:.E..........XXX----------X--------X.H.X...E..X-------------X.XXX............X----------X--X...E........X
---------X................XX-----XXXXXXXX.X-------X....XXX..X--------------XX...E....E..H...XXX-------X.XX.............X
---------X..XXXXX....E......X---X....H....X-------X....EX...X-------------X...........X...H....X----XXX.....X..........X
----XXXXX..X----X..XXX..H.:..X--X....XXE..X-------X.........X-------------X.......X.XXX......XX----X...........HXXXXXXX-
---XE......X---X..X---X......X--X..:X-X.XX---------XXXXXXX..XXXX----------X.H.....XX-X......X-------XX......H..X--------
--X........X---X.E.XXX..H....X---X..X--X-----------------X...E..X---------X.........X....XX.X-------X..........X--------
---X.....XX-----XX............XXX...X--------------------X..XXXX----------X................X--------X..........X--------
---X...XX------XE.................B.X------------------XX..AX------------X..XX..............X-----XX...........X--------
--X.....X------X....H....E.E...H....X-----------------X....X--------------XX-X......X..A....XXXX-X......E....XX---------
---XXXXX-------X..................XX------------------X.EXX-----------------X......X-X..........XX..........X-----------
-XXXXX..X------X....XX.........H..X-------------------X..X-------------------XXX..X--XE.........X-X...XX...X------------
X.H......X-----XE...XX......X.....X-------------------X...XXXXXXXXXXX----------X.EX--X..........X--XXX--X.X-------------
X........X-----X...H.X.A...X...X..X-------------------X...........E..X---------X..XX--X.....XX..X------X..X-------------
-XX......X------XX......X..H...X.X--------------------XH..............X--------X....X--XXXXX--X.X-----X....XXXX---------
X........X--------X............XX---------------------X...........H...:X-------X.H...X--------X..XXX-X.........X--------
XHXX.....X--------X...H.......X---------------XXXXXXXXX:..E............X--------X....X--------X.....X-XXXXX....X--------
X........X--------X.XX........X--------------X....E...................X----------X...X---------XX...X------XXX..X-------
X........XXXX------X-X...XX..X---------------X.......E.H......X...XXXX-----------X.EX------------X...XXXXXX---X.X-------
XEX...X.....AX-----XXH..EX-X.X----X---XXXXXXX.E....H.......XXX...X----------------XX-------------X...X.....X--X.X-------
-XX...XX.....X----X......XX..X---X.X-X..:.......H....X....X---XXX----XX--------------XXX--------X..H.E......X-X.X-------
---XXH..H..A.X-----X.....XXH.X---X.X-X......H...XX...XH...X------X--X.HX-----------XX...X-------X...........XX.HX-------
----X.......XX-----X.........X---X.X-X...........XX..XX..X------X.X-X..X---XXXXX--X...:X-------X....H......X-X..X----XX-
-----X........X----X......EX.X---X..X...HX..E.........X...X-----X..X...X--X.....X-X.....X------X...........X-X...XXXX..X
-----X...E....X-----XXXX.....X---X..XXXXX-X...............X-----X...E..X--X.....XXX..XXX-------X...........X-X.........X
-X---X.......E.X-----X--X.....X--X..XXXX--X.....E.........X-----X......X--X...H....EX----------X..........X-X..........X
X.X-XX..H.......X---X.XXX.....X--X......XX..........E......X-XXX.......X--X..X..E...X----------X.:...X...X.X.....X.....X
X..XH...........XX-XX.........X---X.X..........E...X.......XX.........X---X..E...XXX-----------X.....X.X....E....XX....X
XE.....XX.........X.A.........X---XX-X.....XXXX..........XX--XXX.H...X----X...XX..XX-----------X:................X-X.E.X
X...XXX--XXXX.......X...X.:...X--X.XXX.....X-X........A..X-----X...H.X-XXXX.X.XX....XX----XXXXX..........XXXX..H.X-X...X
X....X-------XXXX..X-X.H.....X---XH.....E...X............X------X..X..X....X-X-X......XXXX...............X---X.XX--X.XX-
X....XXXXX-------X..X.......X----X.........X-X...........X------X..XXAX....X----X........A.......H...H...X---X.X---X.X--
-X........X------X..........X----X..........XE...........X-----XXE.X-XX....X----X.....E.....H............X----X-----X---
-XE....H..X-------X..X.XXXXX-----X.H......E..............X----X.....X--XE..X-----XA.....H..X.......XXX...X--------------
-X...E....X------X...XX-----------XX.......XXXXX.........X-----X..XXXXX..XX-------X.......X-X.....EX-X..HX--------------
--X....EX.X------X:.X------------XXX..X.....E..XX.......XX--XXX.........X--------X........X-X......X-X....X-------------
---XHX....:X-----X..X-----------X..E.X-X.......XXA.....H..XX.:.....H....XXX------X........X-X..HXX.X--XXX..X-X-----X--X-
---X.X.XXXX-------X..XX---------X....X-X......EXX...X......E.........:.....X-XXXXX........XXX...X-X------X.XXEX---X.XXEX
---XE.X------------X...XXX-------X..HX-X.......XX..X-X..X..................XXA.........A........XXX-----X.....X--X.....X
---X..X-------------X...E.X-------XXX-XX..X....X...X-X...H.................X...XXX.........XXXX....X----X.....X--X....X-
-XXX..X-------------X.E...X----------X.H...A.......XX.....XXXXXX..E............X--XH......X--XE..XX------XX.X.XXX.....X-
X.....X--------------X....X----------X.............X-XE........XX..............X-X.........X--XXX----------X...A...XXX--
X.....X--------------X....X----------X..H.....XXXXX---XXXXX....XX..........X...X-X....XXX.HX---------------X.H....X-----
X.XXXX---------------X....X----------X......XX-------------X..X-X......E...XXXX--X.EXXXX....X-------XX-----X..XXXX------
X.X------------XXX--X.....X----------X.....X---------------X..X--XXX.XXXXXX------X......H...X-----XX..X----X.X----------
-X------------X.E.XXX...X.X-----------XX.XX----------------X..X-----X------XX----X...H.......X---XE..X-----X.X----------
-------XXX-XXX............HX-----------X.H.X----------------X.X---XX------X..X----XXXX..X....X---X...XX----X..X----XXXX-
------X...X................X--XXX------X.XX-----------------XHX--X..X------X.X-------XEX-X....X--X..XX.XXX-X.EXXXXX....X
------X..........X........HX-X...X-----XX-------------------X..X-XH.X-----X..XXX----X..X--X...X--X..XX....XX...........X
-X----XE.......E........AXX--X...XX---X.XXXXX-------XXX-XXXX...AX...X-X--X.H....XXX--XXXX-X...X--X.................X...X
X.X-XXX..XXXXX......E....XXXXX.H.E.X-X.......X-----X...X.............X.XX.........:XX....X..EX----XX.E.XXX...XH..XX-XH.X
X..X....X-X--X.....XXXXXE...........XX.....XX------X.......EXX.......H.XX...........XX......XXXXXX--XXX---XXX-X..X--X..X
X.......XX.X-X........X-X...........XX.H...X--X----X........X-XX.H.....XX...XX..XX.X--X...H.......X-----------X...X--XH.
X.......XX..XX........X--XXXX....XX........XXX.XXXX.........X--X...XXXXX..XX--X.X...XX.........A.X------------X....X-X..
XHX.XX..XX...X:......X-------X..X-X..........H.....EXXX.....X-XX..X-----X.X---X.X......:.X.......XX-----------X.E..X-X.E
X..X-X.X-X..XX.......X----XX--X.X-X.................X--X.....X.X..X--X--X.XX--X.E..................X-----------XXXX--X.X
X...X.H.XX......E.....X--X..XX...X.XXXX......XXXXXXHX--X...:.......XX.XX....X-X...........H....H....X----------------X..
X.......XX.............X-X.X.......X-X.....EX-XX--X.X---X..........X........X--X...............XX...X----------------X..
X....:..XX.........A....XX.........X-X.......X..X--X-----X......H.....E.E....X-X...............X-X.EX----------------X..
X.......XX....A.......A.........H..X-X.A........X---------X...................X.....H..........X--XX-------------XXXXX..
X...E.H.X-XXX...X.......H.XXXXX.....X.....:.X..X-----------XH...H.E.X..........E...............X-X.X------------X......X
X.X.....X----X.XX.........XXXX.............X-XX------------X.....................E..........A..X-X.X-----------X...E...X
X.X.....X-----XX.......:.:.......H....E....X---------------X....E...E....................E.....XXH.X----------X....XXXX-
X.XXXX.X--XXXXX...........................EX---------------X....................E.....E............X----------X....X----
-X---X.X-X.......X...X...E.....XX..........X---------------X.....XXXX....................:..XE..E..X----------X....X----
------X--X.....HX-X.X-X.......X--XA.......:X---------------X.....XX-X...E....XXXXXXX.HXXX..X-X....EX-----------XXXX-----
---XXX---X.......X-X--X.......X--X.....XXXX-----------------X...E..X..E.....X-------XX--X..X-X.....X--X-----------------
--X.:.XXX....XX.X------X..A...X-XH.....XXX-------------------X.......XXX.....X----------X..X--XXA..X-X.XX---------------
-X...........XX.X-----X.......X-X.........X------------------X.XE....X--XXXXX-----------X..X---X....XX...X--------------
X......XX.E..X-X-----X........X--XXX.......X------------------X...X.X-------------------X..X----XX:......X----------XXX-
X...X.X-X....X-------X.......XX-----X...E.X-------------------X..X-X--------------------X..X------XX.....X---------X...X
X...E..X......X------X.H..H..H.X----X.....X-------------------X..X-X--------------------X..X--------X...X----------X...X
X..........H..X-------X.XXXX...X----X.....X-------------------X..XX.X-------------------X..X---------X..X----------X..:X
X.E.....E....X---------X----X..X----X....EX---------XXXXX-----X..XX..X------------------X..X---------XH.XXX-------X....X
X..........A.X---------------XX-----X......XXXXXX--X.....XX---X...X..X----------------XX...X----------X....XXXX--X.....X
X.....E......X----------------------X......E...E.XXXX......X---X....X----------------X....X------------X.......XX......X
X............X----------------------X...HX..........E...A.H.X---X.XX-----------------X..XX--------------XX.E...........X
-XXXXXXXXXXXX------------------------XXXX-XXXXXX:....XXXXXXX-----X--------------------XX------------------XXX..HXXXXXXX-
