-XX----XXXXXXXXXXXX-X-----X----------XXX----------------------------------XXX----------XXXXXXXXXXX-------XXXXXXXXXXXXXX-
X..X--X.....E......X.X---X.X--------XH..X----X---------------------------X.W.X--------X.....H...H.X-----X<...:.........X
X..X---X.H.........E.X---X.X--XXXXXX....X---X.X-------------------X------X...X-X-------XXXXX..E.XX------X..............X
X..X----XXX...H......X---X.X-X..H...X..XXXXX...XX---------------XX.X-XXX-XE..XX.XXXXX-------X..X---------X.............X
X...X-----XH.........HXXX..X-X......X.X......E...X-------------X...XX...X............X------X..X----------X...........X-
X....XXXX-X................X-X......XH.....XXXXXX---------------X..XX...........X.....XXXXXX...X----------X..........X--
-X.......XX.....XXEX.......X-X.:....X....H.......X-XXXXXXXXXXXXXXA.HX......AXXXX-XXX...........XX--------X........H..X--
-X.......X......X-XX..XXXXX--X....................X........:........X.......X------X.......X.....X--------XXXH.......X--
--X......A......EX.XXX-------X....H.....H................EXXXX.............X--------XXXXXX...E....X---------X....XX..X--
--X..XX............X---------X......XXX.........:..XXXX..X----X...........X--------------X......XEX---------X..XX-X..X--
---XX--X....E......X-XXXXXXXXX......X..E....E......X---XX--XXX......:....X---------------X........X----------XX---X..X--
------X........XXXX-X........X.H.X:....X...XXX.XX..X------X......EX.......XX-------------X........X---------------X..X--
-----X.........X--XXX........XX........X..X---XX.:X.X----X.....X............X---------XX-X....X..XX--------------XX..X--
------X..X.H...X-X......X....X-X.E.....X...X---X..X.X----X....XXE...H......X---------X..XXX........X------------X....X--
------X.X-X.....X...H.XX-XX...X-X....H.X...X---X.....X----XXXX--X.........X---------X..............X-XX---------X...XXX-
------X.X--XH..........XX.X.X.X--XE........X----XX...X-----------X.......X---------X.H......XXXXX..XX..X----XX--X..H...X
------X.X--X.......H......XHXXHXX......XX.X------XE.X------------X..X....X---------X...XXXXX----XH.X..X----X..XX.......X
-----X...XX....E.........XX.XX.........X-X-----XXX..X------------X..XH...X---------XAXX---------X.....X----X..X.H..XXXX-
-----XX..XX..XXXXXXXXXXXE.X.XX...E......XXXX-XX....X-------------X.......X----------X----------X.....HX----X....XXX-----
----X....X..X-------XXXXXX-X-XB.............X.....X----------XXXXX.......X---------------------X...H.X------X...X-------
---X....XXXX-------X......X--X....................X---XXXXXXX............X---------------------XH...X-------XE..X---XX--
---X.......X-------X......X--X................AX..X--X..B...............HX---------------------X....X-------X....XXX..X-
---X.....XX--------X.......XX.........H.......X-X.X--X........XXXXX.....X----------------------X.....X------X..A.:....X-
--X.E...X----XXXXX-X................XXXXX...X.X-X.X--XA......X----X.XXXX----------------------X.......X----X..........X-
--X......X--X.....X-X...............X..X-X.X-X--X..X-X...E...X-----X----------------------XXXXE........X---X.XXXXXXH..X-
--X.......X-X.....X-X.........X....X..X--XHX-----XX---X......X----X----------------------X.......:......X---X------X..X-
--X........X.....X--X........X-X......X---X----------X........X--X.X------------------X-X.....E.....XXXX-----------X..X-
--X..............XXX....E....HX.....A.X---------------X.E.....XXX..X-----------------X.XX..XXXXXXXXX-------X-XX---XA.X--
-X....E.......E.......E....XXX-XX.....X------------XXXX....E.......X----------------X......X--------------X.XE.X--X...X-
-X........................X-----X....X------------X...............HX---------------X.......X--------------X.....XX.....X
--X......XX.......E.A...H.X-----X...X------XX--XXXX....XXXX..XXX...X--------------X.........X-------------X............X
--X.........B.............X------XXX------X:.XX...X..X.X---XX--X...X--------------X.........X-----X-------X..........H.X
--X.:....X.....E....H.....XX--------------X...X...H.XX.X--X.X--X...X-------XX-----XH....XXXX-----X.XX-----X..H...XX....X
---XX....XX.H...............X--------------X..E.....XX.X-X..EX--XXX---XXXXX..X----->XXXX--------X....X----X......X-X...X
-XX--X...XX........XXXXXX...XXXXXXXX--------X.....:.XX.X-X...X-----XXX...H...X------------------XE..X------X.....X-X...X
X..XX....XX.H......X-----XX....E....X--------XXXXXXXX..X-X...XXX--X........X..X-----------------X...X------X......XX...X
-XH.....E..........X-------X........X--------------X...X-X..E...XX..E.XXXXX-XX------------------X....X-----X...........X
-X...............XX--------X.........X------------X.....XX...........X--------------XX----------X.H.X----XX..X.......E.X
-X..XXXXXXXX....X---------X......E...X------------X.....X.....X......X-------------X..X-------XXXXX.X---X.A.X-X.E......X
-X..X-------X...X--X------X........E.X-------------XE........X-X..XXX--------------X..X------X..E...X---X.XX--X......HX-
-X.EX-------X....XX.X----X...........X--------------X...XXXXX--X....X-------------X...XXXXXXXE.......X---X----X.H.....X-
-X..X--------X......X----X..XX........X--------------XXX--------XXXX--------------X.............E..XXX--------X....B..X-
-X..X--------X..HX.X-----X.XX........X--------------------------------------------X..E.H..E...........X-----XX........X-
-X..X---------X.X..X----XX....E.....X-------------------------X--------------------XXXXXXXXXXXXXXX.XX..X-XXX.........E.X
X...X---------X....X---X.X.........EX------------------------X.X----------------------------------X-X..XX..........XXXX-
X..X----------X.....X-XX........XXX.X------------------------X..X--XXX---------------------------X.XX....E......E.X-----
X..X----------X......X.X........X...X------------------------XH..XX..HX-------------------------X..XX..............X----
X.X-----------X..XE....X......:.H...X---------------XXXX-----X........X------------------------X........A..........X----
-X------------X..X.....X...........X---------------X....X----X........X-------------------------XXXX.E.........H.H.X----
--------------X..X..E..X...XE......HXXXXXXX-------X...X.X----X....X...X-----------X-------------X...............XXX-----
---------------XX-X....XE...............A..X------X.HXX..XX-X.........X----------X.X-----------X..............H...XXX---
-------------------X..........E...X......XX-------X..XX....X.........X--------XXX..X-----------X....H....E...........X--
--------------------XXXX.A.......X-XXX...X--------X..XXH............X-------XX.E...X-----------X.....................X--
----------------------XH.........X---X...XXX------X...X.............X------X.......X-----------X.........H.E.........X--
----------------------X..........X---X......X------XXX-XXXXXX.......X------X.....A.X------------XX...................X--
-------------X--------X........XX----X......X-----------XXXXXXX...EX-------XH......X------------XX.E......A.......E..XX-
------------X.X--XXX--X.......X------X.......X---------X...........X------X...H...X------------X.......................X
------------X..XXH..X-X........X------XXXX....X---------X.......H..X-----X..E...H.X----------XX...X....................X
------------X..X-X..XXX...H..A..X---------X...X-------X--X..X.E.....X---X.H.......X---------X.....X.X.................X-
-------------X..X..H............X---------XE..XX-----X.XX...H.....:.HX--X......E..EX-------X............E..XXX........X-
-XXXXX--------X.XX............X.X---------X.....X----X................XXX...E.XXXXX--------X.........E.....XXXX.......X-
X.....X-------X.XX..X.........X..XX--------XX...X----X...........E......X:...X--------------X..XX..........E.....E.A.X--
-XE...EX------X.X..X-X........X....X---------XXXXXXXXX.......H........A....A.X--------------X.X-X..A................X---
-XXX....XXXXXX......X....H..H.X.:.X-----------X.....H....................X..X--------------X..X-X...........H.......X---
X......H....W....................X------------X............H.....AX.......E.X-------XXXXXXX..X--X.....XXXXX..........X--
-XX......H....XXX.E.....XXX.H....X------------X....:..H...X.....X.X......XXX------XX:.A......XXX......X---X..........X--
-XX.....XXXXXX---XXXXXXX---XXXXX..X-----------X..........X-X....X.X...X....X-----X.............XXXXXX..XXX.........A.XX-
X.E......XXXXX-----------------X..X--XXXXXX--X...E....H..X-X....X.X.....AXX------X..H...X.....E.A..............A..X..:.X
-X....H....H..X----------XXXXXXX..X-X......XX.......XXXXX---XXXX........X--------X......:X............A..........X-X...X
-X...X..X.....X---------X.........XX.......XX....XXX------------X.....AX--------X..E....X-X.H............X....H.XXXX...X
-X......X..XXX----------X.XX..A.........E..X....X---------------X..XXXX----------X....E.X--X............HXE..........XEX
X.....EXX..XXXXX---------X--X.XX..A....XXXX-X....X-----X--------X..X--------------X.....X---X............X...X......X-X-
X......X........X----------X...X.......XX---X.....XX-XX.X-------X..X--------------X.....X---X.....XXXX..A...X-XX...XXX.X
X........E.E...X-----------X..EX.........X--X.......X....XXXXXX-X..X------------XX-X....XXXX.....X....H.....X--X.......X
-X..X.......XXX-------------XXX-X........XX-X....XX.H..XX......XXH.X-----------X..XX...........E.:..........X---X......X
X.......E...X-------------------X.....XX...XX...X-X..XX--XX........X---------XX....E........................X----X.XX..X
X.A..XXXX....X---XX-----------X-X.:...X-X...X..X---XX------XX.E....X--------X........X..E..E..E.....H.......X-----X--X.X
X..XX----X....XXX..X---------X.X.....H.X...X-XXXX------------XX.H..X----XXX-X........X........X..............X--XXX---X-
X..X-----X.........X--------XE..:......X.E..X....X------------X....X--XX...X............E.E...X..XX.........E.XX...X----
X..X----X.......E..X--------X........XX.......H..X------------X.....XX....X-X...............X.X..X-X...E.....X--X..X----
X..X-----XXXXXXXX.X---------X.......X-XE.........X------------X.X......E..X--X.X.E..XXX.XXXX-X-X.X-X.........XXXX..X----
X.X--------------X----XXX--XE......X---X.......E.X----------XXX.XE....XXXX-X-X:....X--X.X------X.XX.............X.AX----
XH.X-----------------X..EXXX.XXXXXX----X..........XX------XX.E........XXXXX.XX.....X---X--------X-X........XX......XXXX-
X..X------------------X..X..X-----------X...........XX---X.........................X--------------X....XXXX-XX.E..E.E..X
X..X------------------X.....XXXX---------X.....E...A..XXX......E............AX.....X--------------X...X----X......XXXXX-
X.X--------------------XE.......X---------X...X.........H...E........H....XXX-XX...X--XXX-------XX....X----X.....:XX----
X.X---------------------X.......X---------X.A..................H........E.X-----X..X-X...X-----X...XXX-----X........X---
-X----------------------X...H....X---------X...H......E...........H.......X----X..X--X.EX------X...X-------X........XXX-
------------------------X.....X..X----------X..............XX...H....E....X---XX..X-X...X------X...XXXXXX---XXXXXX.....X
-----------------XX------X...X-X.X-----------XE.....E......XX.E....H......X--XH.A.XX..XX-------X.........X--------X....X
----XX----------XE.X----XX..E.X...XX---------X...................H.....XXX--X........X---------X.H.......HXXXXX--XH....X
---X..X--X------X...X--XH.......EXH.XXXXXX---X..E......A..E...........X------XXXXX..X----------X...A...........XX....X.X
-XX...X-X.X-----X...X--X...XXXX.XX........X--X......A.........:.......X----------XE..X---------X....................X-X-
X...XX--X..X-----X.X---X...XXXX...........X---X.HXXXXXXX.....XX........X----------X..X----------X.H.............H...X-X-
X..X---X:...X--XX.HX---X..E......X.....H..X--X..X-------X....X-X.....XX-----------X..XX---XX--XXXX..E......H........XX.X
X:..XXX.....X-X....X---X..XXX.EXX-X.....XX---X..X--------XXXX---X...X-------------X....X-X..XX..........E...X..........X
X........X..XX.E...XX--X.........X..E...X----XH.X--------------X....X-----------XXX..XX.X-X.A.E..........X..XXXXXXXXX..X
XH...E..XX...X.......X-X................X----X.X------XXXX---XXX....X----------X.......EX--XXX.XXX.:....X-X.X--------XX-
X.......XX..AXX..XX.X--X.......XX......EX----XEX---XXX....X-X..E....X---------X.........XX----X--X....XX---X.X----------
X..HXXXX--XX....X-X.X--XA.........E.....X----X.X--X...H.XX-X.....XXX----------X......E....X------X:...X----X.X----------
-XXX--------XEXX-XX.X--X................X----X.X--X.H..X----XXXXX-------------X.:......E.X------X.X.E.X---X..X----------
--------XX---X--X....X-X................X----X..XX...XX-----------------------X..........X-----X..:....XXX...X----------
-------X..X-----X.....X..E...............X---X.......X------------------------X....HX.....X-----X...........X---X-------
------X..X------X......H........E.XX.....AXXX........X------------------------X.XXXX-XXXXX-------X...X..X..X---X.X------
------X..X-X----X......XXXXXXXXXXX-X..XXX..........XX--------------------------X------------------X......XX----X..X-----
------X...X.X----XX..E.X-----------X.X---X........X----X-------------------XX---XX----X----------XH......X-----X...XXXX-
------X.....X-XXXX.....X-----------X.X----XA......X---X.X-------------X-XXXE.X-X..XX-X.XXX------X........X-----X.......X
------X....X-X.........X-----------XX-----X.......X--X...X-----------X.X......XX....XX....X----X..........X----X.....XX-
-------X...X-X.A.....H.X--------XXX..XXXXX.B..H...X--X.E..X---------X.....................XXXXX............X--XH....X---
-------X.E.XXX.........X-------X.E.................X-X...X-----------XXX.......X.XXXX..X..X.....E......X....XX.....X----
-------X.......H.......X-----XX.....E.XX...........X-X...X-XXXX--------X......X-X----XXX..........X...X-X...XX..XXX-----
-------X..X...X.X.....X---XXX.E.......XX.........H.X--XE..X....X-----XXX......X-------XX...............X....XXEX--------
-------X..XXXX-X.:XXXX---X.............XX...........XX...HX....X----X.........X------X...XX.X.XX.......X...EX..XX-------
-------X..X----X.X-------X.:..H.......X--XXXXXX:.E.............X----X...XX..XX--------X.X-XX-X..XXX....H.XX.X....X------
-------X:.X-----X---------XXXX.........XXX-----X....XXXXXE.....X-----XXX-X..X----XXX--X.HX..XX.X---XH....X..X:...X------
-------X..X-------------------XH....E.H.A.X----X:.X..X---XXX....X--------X..X---X..HX-X...E.XX.X---X.....X.:...XX-------
-------X..X--------------------X.......XXX-----X..X..XXXX--X....X-------X...XXXXX...XXX.....XX.X---X...:......X---------
--XXXXXXH.X--------------------X.E....X-------X..........X--X.E.X------X..XXX..................X---X.E.......X----------
-X.........X------------------X.......X-------X...X.....X---X..X-------XEX--X....E............X---X......E..E.X---------
--XXXXXXXXX--------------------XXXXXXX---------XXX-XXXXX-----XX---------X----XXXXXXXXXXXXXXXXX-----XXXXXXXXXXX----------
