-----XXXXXXXXXX----X-------XXXXXXXXXXXXX-------X----------------------XXXXXXXXXXXXXXXXXXXXXXXX----------------------XXX-
----X..........X--X.X-----X.............XX----X.X--------------------X.E.....E................X--------------------X...X
-XXXXX........X--X..X-----X.........XX....X--X.HX---------------------X..XX...............A...X--------------------X...X
X......XXXX...X-X....X----X.XXXXX..X--X...X--X..X----------------------XX--X..E..XXXXXXHXXX...X-------------------X..A.X
X......XX-X...X-X....X----X.X--X...X---XXX--X...X----------------X---------X.....X-----X--X...X-------------------X....X
X.H......X-X..XXXX..X------X--X.....XX------X....X------------XXX.X---------XX...X---------X.:X--------------X-XXXX.H..X
X........X--X........X---------XXX....X---XX.E...X-----------X.....XXXX-------X..X----------X.X-------------X.X.....XXX-
-XW......X---X.H.A.XX------------X....X--X........XX---------X....:....XXXX---X...XXX-------X..X------------X....H.X----
-X..E....X----XXXXX------------X--XE..X--X.X........X--------X.............XX-X......X------X..X------------X.A...X-----
-X...X...X---------------X----X.X-XX...X-X..........X---------X.....E........XXE.....X------X..X------------X.....X-----
-X...X...X--------------X.X---X..X......XX.....H.XXX------XXXX-X..:.XXXXX..X.........X-------XX---XXXXXXXX--XE..H.X-----
-X.......XX-------------X..X--X.....H...X-X..XXXX--------X....X....X-----X.X..........XXX--------X........XX......X-----
-X........HXX----------X..E.XX..........XX.W.X-----------X.........X------X...E....H.....X-----XX..........E......X-----
-X....E......X---------X.......A............X-------------XX.......X------X..........E...X----X...............X...X-----
-X..X.........XX--------X...X..XXXE...XXX...X-------X------X.......X-----X.H...E......XXX------XXX...........X-X..X-----
-XH.XX.....A....X--------XXX-XX--X....X--XXX-------X.X--X--X:.......X---X.............XXXXXXXXXX--X.........HX-X..X-----
-X..XX....XXXEXX------------------XXX.X------XX----X.EXX.X--XXXXXXX..X--X...:...................X--XXX.......X-X..X-----
-X...X...X---X--XXX---------------XXXEX--XXXXA.X----X...HX--------X..X--XE....X....E..E....E.....X----XX.X...X-X.EX-----
-X........XXX--X...X-XXX---------X....XXX......X-----X...X--------X...X-X..H..X............X....H.X-----X....X-X.X------
X.......B....XX.....X...X--------X......X.A...X---X-X...X---------X...EX-XX............A...X..XXXX-----X...E.EX..X------
X....XX..............H..X---------XXX...H..XXX---X.XX...X---XXXXXX.....X--X:.....E........XX..X-------X..X.......X------
X.:..X-XE.....XX....XXX.X--------XXX-X...XHX-----X...H..X--X.....E.....X---X...E..........X-XX--------X.XX.......X------
X....X-X....XHX-X....XX..X------X...XX...X.X-----X......X--X..XXXXX....X---X........E..B..X-----------X.XX.......X------
X.....X.......XXX....X-X.X-----X...........X------X......XX...X----X...X---X..............XXX----------X-X.......X------
X......E.............X--XXX---X..H.........X-------X........B.X-----X.EX----XXXXXXXXXXXXX..H.X-----------X..W....X------
X....H....XX.........EXX..EXXXX....X....X..X------X..XX.......X-----XXX------------------X....X----------X.......XXX----
X...X.....EX.....................XX-X......X-----X...X-X...E..XXX-XX..XX-----------------XE...X----------X..........XXX-
XH.X-XXXXXX-XX..H...............X---X...X...XX----X...X-X.....X..X......X----------------X..XX-----------XH...E.....A..X
X..X----------XXX...........E.XX-----XXXX.....X--X.....X..B........:....X-----------------XX----------XX--X............X
X..X------------X.......XX...X---------X.H....XXX.....X.........H..XXXXX-----------------XE.XXXX-----X..X--X.....E....EX
X..X----------X-X......HX-X...X---XXXXXA.........XXXXX-X.B.......XX---------------------X.......X----X..X--X.......X...X
X...X--------X.X...E.EXX---X..X--X...H...E......X------X...XXXXXX-----------------------X........X-XX...XXX......EX-X..X
X.XX---------X.......X----X.X.X-X............A..X------X..X--------------------------XXX...E...XX-X....XX.........XX...X
-X-----------X....XE.X----X...X-X.:.H..........X-------X...X------------------------X..E......X----X..XX..H.......X...X-
--------------X...XX..X---X.E..X...............X-----XXX....X-----------------------X..........X---X.X-XE...A.....XXXX--
--------------X...X.B.X----XXX.XXE.............X----X....E..X-----------------------X........H..X--X..X.........XX------
-----------X-X.A...X...X------X--X.....H......X-----X.......X-----------------------X..........X-XXX............X-------
----------X.X.....X-XXX--X---X.X-X..E..........X----X.E......X-XXX-------------------XX........XX................X------
---------XE..A..XX------XEXXX..X-X.......XX.....X---X.......EXX...X---------------XXXXX.:......X...XXXX.X...H....X------
-XXXXX--X......X--------X......X-X..XXXXX.X.....X---X.A...........X--------------X....E.X....E.X...XXXX.XXX......X------
X.....XX.......X-----XX-X.E..E..X...X---X........X-X.XX...........X--------------X.X...X-XH....XX...A...XE...E...X------
X......H...H..X.X---X..XX...........X----X..X....X-X..X.H..........XXXX-----------X-X..X-X.....X-XXXXXX.X........X------
X................X--X................X-XX........XX...H....H...........XX-------XX.XX..X-X....X--------X-XXXXX.XX-------
X............H.E..XXX...XX...E..XXX.X-X.....X..................X.........X-----X......:.XX:...XXX----XX.XXXXXX.X--------
X.....E..............XXX--XX.....XXX---XXXXX-X....XXX........E.XX...E...HX--XXX.........X-X.....EX-XX..H....H..X--------
X....................X------X......X--------X......X-X.....BX.X--X.......X-X.E...E..X..X---X......X..A......X...X-------
X.............E......X------X..H...X---------X......X-XXXXXX-X---X........X............X---X............H..X-X..X-------
X....................X-------X......X--------X.E..EX-------------X.A..H...............A.X--X.......X.E......X.H..X------
X...........H....E.XXX-------X...H..X---------XXXX..X------------X........XXXXXXXXXX...XXXX.E.....H...XXXX........XXXXX-
X.......H.............XXXXX--X.XX...X-------------XX-------------X.......X----------XXXX............EX---X........H....X
-X.......XX..XX.E..........X-XHXX.H.X----------------------------XH......X-------------X.......XX..XXXXXX..H........H.EX
X.........H.X-X.........XXX---XX..XX-----------------------------X.......X-------------X...E...XX.X-X...........:......X
X.....H.EXX.X--X......XX--------XX-------------------------------X........X-------------X......XX..X.E........H........X
X.E......XX.X---XXXX.X--------------------------------------------X.......X-X-----------X.....X-X..E....XXX....X.......X
X...XX..X--X--------X---------------------------------------------X..XXX...X.X----------X.X..X--X.XX...X---X.HXXEX.....X
X..X--X.X---------------------------------------------------------X..X--XX....X----------XX..X---X...X..X---XX--X-X....X
X...XX.HX---------------------------------------------------------X.E.X-X....X----------XXX..X---X..X-XX----X-----X....X
X...X-XX---------------XX-----------------------------------------X..X--X...X----------X....X----X...X-----X.XXX---X...X
X...X-----------------X..XXXXX------------------------------------X..X---X..X----------X...X-----XE..X-----X....X-XH.XX-
XE..X-----------------X...H..<X------------------------------------XX-----X.X-----------XE..XXXXXXX...XXXXX....AX--XX---
X....X-XXX------X---XX........X--------------------------------XXXXXXX----X.X------------X........XXX.A..A.....X----XX--
X....XX.:.X----X.X-X..E......X--------------------------------X...H...X----X-----------XXE...E....X-X....XXX....XXXX..X-
X.........X----X..XX.X.....X..X-------------------------------X........XX----X--------X............X-XXXXXXX....E....X--
-X...XX...X----X.X--XX...A....X-------------------------------X..:....H..X--X.X-------X...........X----X..........X...X-
--XXX--X..X----X.X--X.........X-------------------------------X..........XXXX.XXXXXXXXX.........E.XXX--X............XX--
-------X..X----X.X--X.......A.X--------------------X----------X.X............E.......H........XX..E..X--XXXX.X...H.X----
-------X..X----X.XXXX....H..XX--------------------X.X----------X-XA..:........................X-X....X-X.XX.....XX.X----
-------X..X----X...........X----------------------X..X------------XXX...X.....X........E....E.X-X.....XX..:.....XX.X----
-------X...XXXX.E..........X-------------------XXXX..XXXXXXX--------X.A.XXX..X-X...X.E........XXH.....XX......H..X.X----
-------X................XXX--------------XXX--X.............XXXXX---X..X......X....XXX.....E........E.X-XX......HX..X-X-
-------X........E..X...XX---------------X...X-XH.................X--X.HXXXX.....E..XXX............XX..X-X...XXXXXX...X.X
-------X....H.A....XXX...XX-------------X...X-X......XXX.X........XX...X--X....X...H.........H.H.:X-X.X--X.X-----XH....X
-XXX----X.XX.XXXX.X--X.....X------------X...X-X......X--X-XX......:...X---X......................X-XEX----X--XX--X....HX
X...X----X--X--X...XX-X....X-----------X.H..X-X.....E.X----X..XXXXXXXX---X.X..E.XXX....X.....X...X-X..XX----X.AX--X....X
X.E..X--------X......X-XXX.X----------X..XXX--X.XXXXX.X----X.X-----------X:.......E.H.X-XXXXX.....X.....X---X..X-X.....X
X....X---------XXXXXX-X--X.X----------X..X----X.X----X-----X..X----------X...........X------X..XXX-X.....XXXX..XX......X
X....X---------X.XXX-X.X-X.X-XXXXXXX--X..X---X..XXX---------XX-----------X...........X------X.X-----X..........E..E....X
XH....X-XXXXXXX..E..X..X--X-X.......X-X..X---X...E.X-------------XX--X---X.........H..X------X------X...XXXX...........X
X......X...........X-X.X----X......XX-X..X----XXXXX-------------X.HXX.X-XX...E........X-------------XH..XX--X..........X
X..................XX...X----X.E.....X.H.X----------------------X.....XX.......A.......XX----XXXX---X.....XX.......A...X
X..E.............E.XX...X----X...........X----------------------X............XXXX........X--X....X--X.....XX...E.H.....X
X.........X....XX..X....X----X.........H.X----------------------X....XXXXXXXX----XXX.....X--X.....XX.......X...........X
X......E.X-XXXX--X:.....X---X............X----XXXXXXX-----------X.H...X---------X.....E..X--X.....X....X......XE.....A.X
X.......X--------X....:.X---X....H...:.E..X--X..E...EX----------X....AX----------XXX.....X--X.XX...E...X...............X
X.....A.X--------X.XX..X----X.....XXXX.....X-X.......X-----------XX...X-------------XXX..X---X--XXXXX..XX..X.:......X.EX
X.......X---------X--X..X----X..EX----XXXX.X-X........XX-----------XX.X-------------XXX..X----X-----X.....H..XX.....X..X
X....XX.X------XX----X...X---X....X-------X---XXH....:..X----------X..XXXXX--------X..XX.X---X.XXXXXX....XXXX-X.....XX.X
X.H..XX.X-----X..X---X....X--X.XX..X------------X.......X-----------X...E..X-------X..X-X--X-X..........X------XX......X
X....X.EX-XXXX..X---X.....X--X.X-X.X------------X..XX...X-----------X.....X--------X..XX.XX.X..:......H..XX------XXX....
X........X.....X-----XX...X--X..X-X---XX---------X......X------X----XE...X---------X........HX...........H.X--XXX---X...
XE.XE....X...A.X-------X..X-X:..X----X..X-XXXX----X.XXXX---XXXX.XXXX.....X---------X..XX..X..XX............X-X...X---X..
-XXX..H..XX....X---XX--XH.XX....X---X...XX....X-XX..XXX-XXX..........E...X---------X..X..X-X......E..X.XXXX--X...X--X..X
----XX...X......X-X..XX..........XXXX..X--X.X.XX...E...X..XX......XX..XXX-----------X.X..XX....H.....X.X-----X...X--X..X
------X.........X-X....A..A.H..E.......XXXXXX............X--X....X-X..X--------------X-XX-X:.XXXXXXX.XX-------X..X--X..X
------X.........X-X..................E...H......A...:.H..X--X...X---XX--------------------X..X------X-XXX-----X..X--X..X
-------XXXX.....X--XX...E..................X.............X--X...X-------------------------X..X-------X...X---X...X---X.X
----------X....X----X.H.......E...A.....H.X-XX...........X---X..X-------------------------X..X--------XX.X--X....X---X.X
---------X...H.X-----X....................X--X..H.XX....H.XXX-X.XXXXXXXXXXX---------------X...X-XXXXXXXX.X--X:...X-XX..X
-XX------X.....X------XE..X...:.X........X--X.A...X.X......E.XX...E.H.....:X--------------X....X.........X--X.....X....X
XE.X-----X.HXXX-------X...XX...X-X......X---X.....A..........XX............X-XXXXX--------X..............X---XXX...X...X
X..X--XXXX..X---------X........X-XE.AXE..XXXX...A........A....XXXX..........X.....XXX------XXXXX.........X------X..X...X
X..X-X......X---------X....A...X-X............................X---X.E......HXX.:.....XXX--------X........X-------X....X-
X..XXX.....X-------X--X.......X--X........H................E...XXXX........X-X.......X..X------X..H.H....X--------XXX.X-
X.....XX..EX----XXX.X--X..X...X--X...............XXX.XXXX..............EXXX--X.......X...X------XXXX......X---------X.X-
X...H.......XXXX....X-X...E....XX......B..........EXX----X..H...XH......X----X.......XE..X----------X.H....X-XXXXXXXXX--
-X.......A..........XX.........X:.X.XE..............X----X.....XX....H..X----X......B...HX----------X.....X-X........X--
--X............XX.XX-X....H.......XX-XX.......E.....X-----X.....X..E.....X---X....H..X...XXXX-XX-XX-X....X-X......X...X-
---XXXXXXXX...X--X----XX....H...XX-----X.H..........X-----X.X..X-X.XXXX..X---X.......X.......X..XE.X.....XX....XXXX....X
-XXXXXX---XX.X--X.XX-XXX.......X-------X...X.........XXXX-X.X...X.X----XX----X.....EX-XXE.....H.......:........X-X.E...X
X......XXX....XX.:..X..........X-------X.....H....H......XXH......X-----------XXX..X---X....E.............XXXX.X-X...XX-
X.H...XX:.....X.....XXXXXXXXX...X------X.....................XX....XXXXXXXXXXX--X..X---X...........E.....X----X--X..X---
X.........A...X.....X..X-----XXH.X-----X.....H............X....H..............X-X.X----XE.....EXXXXXXX...XXX-----X..X-X-
X.............X.HX....X---->---XX------X.............XX......XXXX.............X--X-----X......X-------X.....X-----X.XX.X
X........X......X-XH...X--X.X-----------XXXXH.:.X..HX--X....X----XXXXX.....XXX---------X.....X---------X....X-----X....X
X......XX-X....X--X...A.XX..X---------------X..X-XXX----XX.:X---------X...X------------X.X..X-----------XX..X-----X.HXX-
X.......X-X....X--X.........X-----------XXXX....X...X-----X.X------XXXXE..X------------X.A.HX------------X...X----X.X---
X.......XX.....X---X.XXXXX.X-----------X............X-----X.X-----XE......X------------X.....X------------X..X-----X----
X......X-X.XXXX-----X-----X-----------X.XE....XXXXX.X------X----XXX..XXXXX-------------X.....XX-----------X..XXXXX------
-XXX...HX..X--------------------------X......X----X.X----------X......X-----------------XX.....X-----------X.....EX-----
----XXXX-XX----------------------------XXXXXX------X------------XXXXXX--------------------XXXXX-------------XXXXXX------
