----------XXXXXXX-----X---XX--
---------X<......X---X.X-X..X-
-XXX----X....E....X--X.BX..BX-
X...X----XXXXXXX.HXX-X......X-
X...XXX>--------X...XX......WX
X.......X-------X...E.EXXXXXX-
X..B....X-----XXX......X---XX-
X..XXXXX-----X..H......X--X..X
X.X---------X.........X---X..X
X.X--------X..HXXE..E.X---X..X
X.X-------XB...XX.....X--X...X
X..X------X.XXX--XBXX.X--XH..X
X.EX-------X------X...X--X...X
X..X-------------XH....X-X.HX-
X..X--------------XX...X-X.X--
X..X----------------X...X..X--
X..X--XX-----XXXXXXX.......X--
XE..XX..XXXXX....E.X.......X--
X..:....X..................X--
X..XX.....X................X--
X..X-X...X-X....XXXX......EX--
XA.XX....X--XXXX---X..W.....X-
-X.......X---------XB.XX.H...X
X.......X---------X...X-X....X
X......X----------X...X-X..E.X
-X......XXX-------XE..X-X....X
-X.........XX-----X..X--X..A.X
-XW...B.....:X-----X..X-XW...X
X..XX........X-----X..X-X....X
-XX--XXXXXXXX-------XX---XXXX-
