-XXXX----X----X-XXXXXXXX---------XXX-XX-
X..E.X--X.X--X.X....E...X-------X...X..X
X.....X-X..X-X..........X-------X...XX.X
X......X...AX...........X-------X.XX-X.X
X..............E..H.W.EX--------X.X-X..X
X...XXXXXXXXE......X..X---------X.X-X..X
X...X-------XX.....XX..X-------X...X...X
X...X---------XXX....H.X------X.E......X
X....XXXX------X.......X---XXX......HXX-
X..E....EX----X........X--X:.....E..X---
X........X----X.H......X-X..........X---
X...X.XXX-----X......:.X--X.........X---
X....X--------X..X.....X-X....XX.....XX-
X..X..XXX----X...X......X..............X
X..X.....X---X.......:....E...E........X
X.....H..X---X..................E.H....X
X........XXXXX.....XXXXXXX...A........BX
X.................X-------X.........E..X
X.......A.E...E....X------X...H........X
X.XXXXE...........E.X-----X..X..A......X
-X---X...XXX....XXXX------X.X-X.......HX
------XXX---XXXX------XXXXX..XXX.......X
---------------------X....E..X..XX.H...X
-XXX-----------------X...XXXX-X.X-X.....
X...X---------------XXXX.X----X..X...X..
X....XX------------X.....X----X.A..H.X..
X......XX----XXXXXX...E..X---X....XXXX.X
X........XXXX...........X---X....X-X...X
X...................X...X-XXX....X-X...X
XE........X...:.E..X-X..XX.......X-X...X
X.......XX-XXXXX..XXXXXX.......H.X--XXX-
X...XX..X------X.......XX........X--X.<X
X.EX-X..XXXXX--XEX......X........X-X...X
X.X--X.......X-X.XXXXX.X-XXX.....X-X..HX
-X---X...H...X-X.X----X-----X..X.X-X...X
-----X.....H.X-X.X----------XX...X-X..HX
----X........X-X.XX--X---XXX.....X-XH..X
-----X.......>-X.:.XX.X-X...H....AXX...X
------XXXXX...XX.......XH......X.....XX-
-----------XXX--XXXXXXX-XXXXXXX-XXXXX---
