--------------------
----XXXXXXXXXXXX----
----X..........X----
----X..........X----
----X..........X----
----XXXXX.XXXXXX----
--------X.X---------
--------X.X---------
XXXXXXXXX.XXXXXXXXX-
X.................X-
X.................X-
XXXXXXXX..XXXXXXXXX-
-------X..X---------
-------X..X---------
----XXXX..XXXXXX----
----X..........X----
----X..........X----
----X..........X----
----XXXXXXXXXXXX----
--------------------
