-XXXXXX------------------------X--------
X......X----------------------X.X-------
-XXXXX.X----------------------X.XXXXXXX-
---XXX.XXX-------------------X.........X
--X.......X--------XXXXXXX---X.........X
--X...X..X--------X.......X--X.....XXXX-
-X...X-X.X--------X.......X--X.....X----
X....X-X..X--------X......X-X.......X---
X....X-X..X---------X.....X-X........X--
X....XXX..X--------X......X-X.........X-
-XX.......X-------X.....XX--X.........X-
--X.......X-------X..X.X----X..........X
--X.......X-------X.....X---X........X.X
--X.......X----XXX.......XXX........X-X-
--X........XXXX....................X----
--X...............................X-----
-X................................X-----
X..............XX..................X----
X........XX...X--X.....X............X---
X.......X--XXX---X..................X---
X.......X--------X.................X----
X.......X--------X.................X----
X.......X--------X.................X----
X.......X--------X..................X---
X.......X--------X........XXXXXXXX...X--
-XXXXXX.X---------XX...XX.X------X...X--
------X.X--X--------XXX-X.X------X...X--
-XXXXXX.XXX.X-----------X..X------X.X---
X...........X---XXXXXX--X...X-----X.X---
X.........XX---X......XXX...X-----X.X---
X.......XX-----X.............X----X.X---
-XX....X-------X.............X----X.X---
--X....X-------X............X-----X.X---
--X.....X-------XXXXX.......X-----X.XXX-
---XXXX.X-----------X.......X-----X....X
------X.X-----------X.......X------XX..X
-------X------------X.......X--------X.X
--------------------X.......X--------X.X
--------------------X......X---------X.X
---------------------XXXXXX-----------X-
